CENSUS TRACT,Total HH,HH above poverty level,HH below Poverty Level,HH receiving benefits,HH not receiving benefits,HH White alone ,HH Black Alone,HH American Indian alone,HH Asian alone,HH Pacific Islander alone,HH Other race alone,HH Two or more races,HH Hispanic or Latino origin (any race),Total Median Income
17031010100,2316,1567,749,433,1883,1158,1003,0,28,0,37,90,215,37985
17031010201,2688,1979,709,851,1837,1379,914,15,51,0,205,124,513,39549
17031010202,1102,889,213,232,870,425,431,14,69,0,146,17,251,38370
17031010300,3037,2571,466,470,2567,1884,828,0,28,0,160,137,418,38866
17031010400,1938,1518,420,277,1661,1448,323,0,89,0,17,61,93,39152
17031010501,2425,1967,458,466,1959,1452,676,0,64,0,120,113,231,34455
17031010502,1508,1153,355,180,1328,962,438,0,69,0,30,9,85,37500
17031010503,968,578,390,296,672,638,130,0,122,0,8,70,54,20357
17031010600,2875,2178,697,365,2510,1956,536,0,89,0,182,112,484,47549
17031010701,1459,1196,263,273,1186,1006,239,0,150,0,40,24,222,55529
17031010702,2060,1632,428,406,1654,1256,512,0,112,0,144,36,510,41161
17031020100,1556,1352,204,250,1306,705,393,0,177,0,196,85,280,51346
17031020200,2135,1890,245,352,1783,1304,416,0,346,0,55,14,236,66831
17031020301,2025,1712,313,276,1749,1707,70,12,160,0,58,18,133,54496
17031020302,1736,1405,331,233,1503,1315,160,7,173,0,18,63,201,72572
17031020400,1669,1403,266,162,1507,1094,295,0,194,0,41,45,243,63977
17031020500,2135,1676,459,593,1542,855,381,0,604,0,118,177,482,41432
17031020601,1979,1626,353,616,1363,1216,126,116,391,0,74,56,78,41308
17031020602,1421,1111,310,251,1170,829,112,0,369,0,57,54,184,53234
17031020701,631,595,36,57,574,477,40,5,93,0,6,10,71,91477
17031020702,2343,1960,383,675,1668,1559,222,0,459,0,103,0,408,47063
17031020801,2162,1841,321,435,1727,1569,42,0,429,0,35,87,429,51467
17031020802,2323,1863,460,751,1572,1108,305,43,662,0,38,167,363,48067
17031020901,1871,1483,388,473,1398,920,338,0,426,0,74,113,361,49901
17031020902,1616,1271,345,417,1199,952,222,0,375,0,48,19,282,37405
17031030101,1947,1709,238,282,1665,1223,374,0,237,0,51,62,301,48927
17031030102,1768,1480,288,106,1662,1061,291,20,231,0,126,39,122,45086
17031030103,916,768,148,28,888,547,242,0,111,7,9,0,122,49103
17031030104,1072,786,286,107,965,752,100,0,181,0,25,14,81,37586
17031030200,2505,2218,287,49,2456,2202,99,0,89,0,67,48,275,65810
17031030300,1482,1129,353,294,1188,951,151,14,199,0,74,93,354,38427
17031030400,1307,1091,216,240,1067,1119,36,27,73,0,24,28,366,50781
17031030500,2918,2816,102,119,2799,2441,98,0,215,0,67,97,408,79414
17031030601,1976,1663,313,488,1488,1298,366,0,277,0,0,35,233,41675
17031030603,1415,1090,325,235,1180,800,424,24,118,0,12,37,183,34415
17031030604,2129,1625,504,299,1830,1156,483,0,360,0,0,130,129,35096
17031030701,901,753,148,151,750,549,196,11,91,0,25,29,71,41042
17031030702,1429,1211,218,69,1360,907,75,0,401,0,0,46,49,59414
17031030703,1763,1290,473,396,1367,1145,402,0,88,0,34,94,164,40195
17031030706,2008,1781,227,162,1846,1391,304,0,283,0,0,30,111,39308
17031030800,1949,1789,160,96,1853,1638,58,0,189,0,53,11,203,90288
17031030900,1395,1277,118,115,1280,1167,64,0,105,0,23,36,102,95958
17031031000,2005,1912,93,123,1882,1665,90,0,119,0,26,105,268,81291
17031031100,2313,1971,342,94,2219,1885,30,0,227,0,50,121,239,68304
17031031200,2736,1877,859,943,1793,1782,522,17,235,0,80,100,537,40380
17031031300,4089,3288,801,653,3436,2483,683,18,800,0,59,46,290,41445
17031031400,3015,2760,255,74,2941,2236,287,0,360,0,25,107,202,69590
17031031501,1850,1156,694,753,1097,786,485,0,427,0,78,74,196,25257
17031031502,2378,1499,879,941,1437,1168,980,0,130,0,54,46,255,25317
17031031700,3531,2754,777,618,2913,2349,773,65,232,0,93,19,285,56175
17031031800,966,881,85,50,916,827,18,0,62,0,16,43,100,78558
17031031900,1260,1174,86,52,1208,1026,86,13,64,0,19,52,123,67760
17031032100,3850,2970,880,692,3158,3303,123,0,109,0,96,219,611,53013
17031040100,1603,1512,91,89,1514,1362,68,0,81,0,59,33,192,85368
17031040201,2962,2702,260,202,2760,2327,37,0,249,0,229,120,559,71322
17031040202,2961,2310,651,574,2387,1911,79,0,550,0,202,219,491,40011
17031040300,1062,1025,37,50,1012,710,31,0,258,0,0,63,66,90250
17031040401,1342,1312,30,38,1304,1053,65,0,126,0,50,48,228,89063
17031040402,2546,2338,208,163,2383,2197,33,0,138,0,50,128,257,82798
17031040600,1131,1075,56,12,1119,1074,22,0,17,0,9,9,112,82383
17031040700,1564,1446,118,98,1466,1332,84,0,40,0,80,28,180,76915
17031040800,807,777,30,31,776,689,22,0,42,0,17,37,73,76809
17031040900,963,902,61,0,963,879,25,0,17,0,11,31,18,76964
17031050100,1132,1073,59,11,1121,995,18,0,50,0,11,58,44,114012
17031050200,2206,2117,89,156,2050,2033,33,0,98,0,11,31,183,85671
17031050300,1095,992,103,58,1037,930,0,0,120,0,32,13,233,84844
17031050500,2115,2059,56,25,2090,1932,0,0,107,0,14,62,213,133845
17031050600,1092,1034,58,24,1068,1049,2,0,28,0,0,13,61,105513
17031050700,680,642,38,28,652,648,0,5,22,0,0,5,25,124500
17031050800,608,584,24,21,587,567,14,0,12,0,8,7,52,116000
17031050900,540,513,27,5,535,454,5,0,53,0,13,15,62,91719
17031051000,714,657,57,23,691,617,35,0,39,0,7,16,166,109130
17031051100,605,582,23,12,593,545,0,0,26,0,15,19,83,136131
17031051200,596,586,10,6,590,549,21,0,6,0,0,20,27,129167
17031051300,1114,1096,18,9,1105,1011,26,0,54,0,9,14,72,178750
17031051400,778,726,52,29,749,665,28,0,59,0,11,15,63,116364
17031060100,1234,1181,53,51,1183,1079,67,0,39,0,16,33,91,92593
17031060200,1121,995,126,34,1087,1015,23,0,26,9,19,29,164,72679
17031060300,1327,1303,24,40,1287,1157,38,0,107,0,0,25,97,117415
17031060400,1548,1448,100,13,1535,1451,7,0,15,0,42,33,181,122708
17031060500,754,549,205,201,553,544,47,0,120,0,17,26,145,34130
17031060800,3063,2899,164,80,2983,2420,163,0,252,0,47,181,157,87723
17031060900,4680,4381,299,164,4516,3972,310,0,221,0,122,55,717,59942
17031061000,1074,964,110,20,1054,969,15,0,47,0,13,30,108,116389
17031061100,602,579,23,0,602,564,5,0,27,0,0,6,24,107500
17031061200,781,726,55,17,764,719,7,0,22,0,18,15,56,112292
17031061500,808,756,52,5,803,735,11,0,30,0,0,32,76,125000
17031061800,697,616,81,8,689,524,41,0,61,0,28,43,74,73523
17031061901,2194,1912,282,88,2106,1678,47,0,340,0,63,66,136,60909
17031061902,2875,2566,309,131,2744,2495,51,19,208,0,20,82,83,64508
17031062000,1546,1479,67,21,1525,1327,26,0,127,0,13,53,71,80595
17031062100,1834,1510,324,118,1716,1593,89,0,106,0,10,36,177,94500
17031062200,1234,1131,103,57,1177,1095,46,0,53,0,40,0,102,119392
17031062300,698,667,31,6,692,634,0,0,47,0,6,11,19,154000
17031062400,720,681,39,71,649,632,36,0,35,0,4,13,4,127059
17031062500,712,643,69,21,691,664,6,0,42,0,0,0,30,131818
17031062600,972,953,19,0,972,787,23,0,135,0,0,27,56,158125
17031062700,1089,1047,42,51,1038,1020,8,10,30,0,7,14,50,168352
17031062800,1448,1391,57,32,1416,1241,37,0,120,0,0,50,101,143667
17031062900,1822,1693,129,15,1807,1559,105,0,78,0,8,72,62,128750
17031063000,1793,1679,114,8,1785,1443,79,0,197,12,27,35,116,99213
17031063100,1296,1199,97,19,1277,1114,21,0,78,0,8,75,105,95365
17031063200,4214,3912,302,12,4202,3896,49,0,247,0,0,22,239,65426
17031063301,1841,1490,351,186,1655,1467,146,0,99,0,25,104,135,58371
17031063302,2710,2469,241,0,2710,2400,116,0,165,0,0,29,197,78720
17031063303,907,841,66,16,891,828,3,0,71,0,0,5,22,81705
17031063400,1161,1073,88,0,1161,1030,45,0,78,0,0,8,65,97305
17031070101,2562,2185,377,69,2493,2182,20,15,206,0,26,113,117,64968
17031070102,1859,1711,148,17,1842,1626,26,0,136,14,10,47,157,70057
17031070103,1203,1066,137,0,1203,992,83,0,119,0,0,9,53,58914
17031070200,2036,1796,240,46,1990,1787,75,0,154,0,0,20,45,92441
17031070300,1629,1498,131,32,1597,1511,0,0,59,0,0,59,64,143221
17031070400,1578,1295,283,300,1278,1225,164,0,131,0,27,31,84,113409
17031070500,1317,1216,101,41,1276,1215,38,0,56,0,0,8,32,155729
17031070600,1259,1186,73,19,1240,1150,12,0,77,0,0,20,70,157125
17031070700,1700,1514,186,131,1569,1286,169,0,174,0,40,31,213,120192
17031071000,999,903,96,7,992,922,52,0,17,0,0,8,0,138934
17031071100,1086,1027,59,0,1086,978,26,0,58,0,0,24,42,119432
17031071200,978,850,128,30,948,868,31,0,57,0,0,22,146,109191
17031071300,1855,1712,143,0,1855,1591,45,0,148,0,11,60,81,112788
17031071400,2808,2410,398,123,2685,2309,97,0,177,0,23,202,310,93529
17031071500,3857,3670,187,0,3857,3313,113,0,307,0,32,92,110,94598
17031071600,739,665,74,68,671,612,77,0,40,0,0,10,50,142583
17031071700,659,639,20,11,648,538,46,0,58,0,0,17,17,162054
17031071800,1120,1048,72,87,1033,900,120,0,91,0,0,9,52,141806
17031080100,4005,3735,270,76,3929,3573,177,34,195,0,0,26,48,111372
17031080201,2213,2198,15,53,2160,1823,115,68,152,0,36,19,50,87221
17031080202,2238,1965,273,15,2223,1994,104,0,124,0,16,0,134,83806
17031080300,2840,2722,118,28,2812,2517,70,0,223,0,14,16,153,122479
17031080400,1862,1347,515,624,1238,694,1020,0,59,0,0,89,30,36927
17031081000,4381,3401,980,584,3797,2996,673,0,623,0,37,52,287,60566
17031081100,2758,2210,548,289,2469,2169,267,0,193,0,39,90,319,77267
17031081201,2901,2752,149,18,2883,2464,76,0,295,0,34,32,170,98186
17031081202,1735,1687,48,0,1735,1526,60,0,105,0,44,0,32,133079
17031081300,3411,2907,504,0,3411,2785,108,0,459,0,26,33,139,84223
17031081401,1501,1325,176,22,1479,1194,34,0,206,0,0,67,36,67313
17031081402,3157,2858,299,77,3080,2379,155,0,589,0,0,34,116,111970
17031081403,5359,4707,652,29,5330,3960,162,27,1160,0,50,0,291,121318
17031081500,3076,2690,386,54,3022,2113,106,0,706,0,76,75,226,103664
17031081600,2663,2405,258,12,2651,1914,161,0,499,0,13,76,107,116897
17031081700,2533,2352,181,74,2459,2041,94,36,300,0,0,62,187,100708
17031081800,6215,6041,174,0,6215,5442,251,0,429,0,0,93,139,128243
17031081900,411,325,86,100,311,248,118,7,25,0,13,0,11,158375
17031090100,1405,1340,65,33,1372,1280,11,0,84,0,21,9,138,95990
17031090200,2741,2633,108,26,2715,2620,54,0,67,0,0,0,124,103733
17031090300,497,465,32,8,489,473,0,0,18,0,0,6,3,97102
17031100100,2145,1954,191,238,1907,2040,0,0,90,0,15,0,236,79665
17031100200,2869,2540,329,187,2682,2649,56,0,10,0,143,11,251,74201
17031100300,2670,2520,150,79,2591,2454,0,0,109,0,82,25,193,83197
17031100400,1253,1127,126,42,1211,1215,0,0,34,0,4,0,101,93778
17031100500,2315,2119,196,174,2141,2016,14,0,86,11,112,76,308,75759
17031100600,1899,1807,92,212,1687,1671,0,0,131,0,55,42,226,75601
17031100700,1825,1741,84,33,1792,1689,0,0,62,0,65,9,247,81458
17031110100,2087,1845,242,115,1972,1874,32,0,115,0,51,15,291,79122
17031110200,1224,1123,101,194,1030,937,39,13,128,0,107,0,185,81731
17031110300,2024,1808,216,207,1817,1694,0,30,145,0,87,68,375,81014
17031110400,1847,1682,165,67,1780,1506,18,0,128,0,144,51,405,69736
17031110501,1794,1692,102,121,1673,1461,19,0,154,0,83,77,405,86512
17031110502,1539,1425,114,254,1285,1158,58,45,81,0,128,69,276,59875
17031120100,1533,1452,81,30,1503,1454,7,0,19,0,53,0,53,133622
17031120200,1778,1680,98,99,1679,1482,13,0,143,0,96,44,186,105833
17031120300,2415,2235,180,19,2396,1999,11,0,348,0,22,35,172,123818
17031120400,1256,1145,111,99,1157,973,0,0,155,0,96,32,259,78750
17031130100,1935,1560,375,358,1577,1322,25,0,544,0,0,44,109,43438
17031130200,656,633,23,37,619,525,0,0,71,0,33,27,104,79167
17031130300,1790,1518,272,297,1493,1173,77,13,367,0,105,55,346,56882
17031140100,1141,885,256,202,939,792,141,10,113,0,80,5,389,42868
17031140200,1723,1233,490,427,1296,898,118,0,393,0,276,38,662,43125
17031140301,776,587,189,144,632,368,20,11,222,0,141,14,345,46534
17031140302,1259,1115,144,153,1106,718,45,0,206,0,202,88,397,72713
17031140400,2256,2081,175,164,2092,1618,15,0,343,0,170,110,532,70682
17031140500,1297,1152,145,217,1080,818,63,0,188,0,228,0,498,62264
17031140601,922,747,175,269,653,455,65,0,202,0,188,12,410,48077
17031140602,1611,1267,344,533,1078,968,152,0,224,0,232,35,717,51982
17031140701,1066,950,116,131,935,547,61,9,175,0,194,80,418,63571
17031140702,2076,1747,329,331,1745,1457,91,3,112,0,372,41,1106,58824
17031140800,2551,2250,301,297,2254,1733,61,0,307,0,343,107,673,71366
17031150200,2901,2446,455,304,2597,2455,0,0,138,0,210,98,727,68157
17031150300,2927,2651,276,188,2739,2430,111,0,67,0,169,150,553,76545
17031150401,1838,1651,187,285,1553,1574,66,9,55,0,86,48,399,64225
17031150402,1263,1190,73,162,1101,1043,19,0,38,0,150,13,262,76017
17031150501,1417,1336,81,86,1331,1145,39,11,96,0,96,30,252,69320
17031150502,1498,1240,258,206,1292,1219,43,0,108,0,121,7,269,61967
17031150600,1394,1260,134,126,1268,974,29,29,160,0,196,6,423,67500
17031150700,1472,1218,254,128,1344,1226,0,0,70,0,156,20,527,71190
17031150800,1677,1572,105,278,1399,1140,34,7,112,0,343,41,599,56917
17031151001,903,719,184,148,755,600,34,0,53,0,176,40,459,62734
17031151002,1567,1396,171,206,1361,1152,41,0,23,14,326,11,827,55125
17031151100,1775,1522,253,277,1498,1311,21,0,74,0,339,30,763,59917
17031151200,1217,1084,133,82,1135,1050,0,0,30,0,137,0,420,64875
17031160100,993,862,131,135,858,726,15,0,153,0,24,75,181,69844
17031160200,1203,1109,94,52,1151,1039,13,0,112,0,39,0,168,82765
17031160300,1885,1693,192,112,1773,1360,103,37,209,0,67,109,290,56790
17031160400,1828,1611,217,178,1650,1344,148,0,108,0,141,87,551,56029
17031160501,1238,1057,181,285,953,803,74,0,190,0,124,47,588,56190
17031160502,1300,1123,177,182,1118,979,19,0,80,0,127,95,686,57400
17031160601,1322,1219,103,96,1226,1088,26,0,49,0,142,17,509,68902
17031160602,1442,1345,97,110,1332,1035,50,0,121,19,156,61,431,64917
17031160700,2278,2024,254,227,2051,1791,35,0,183,0,184,85,838,79671
17031160800,1837,1713,124,172,1665,1424,12,0,175,12,203,11,835,60409
17031160900,1068,989,79,52,1016,870,20,0,81,0,42,55,292,82872
17031161000,823,756,67,38,785,678,39,0,18,0,64,24,237,82740
17031161100,785,775,10,86,699,636,50,0,49,0,0,50,59,116563
17031161200,958,858,100,90,868,808,6,9,50,0,70,15,461,62250
17031161300,1450,1297,153,100,1350,1226,56,0,36,0,93,39,702,47931
17031170100,1047,919,128,93,954,924,52,0,23,0,48,0,131,53882
17031170200,1201,1155,46,127,1074,1001,0,0,81,0,107,12,371,72122
17031170300,1831,1613,218,201,1630,1587,0,11,95,0,138,0,523,64455
17031170400,1507,1346,161,69,1438,1274,50,27,78,0,78,0,247,63281
17031170500,2004,1905,99,93,1911,1735,0,0,120,0,138,11,411,84569
17031170600,976,910,66,60,916,945,7,0,12,0,0,12,115,72574
17031170700,1149,1008,141,46,1103,1011,7,0,78,0,53,0,166,73133
17031170800,1438,1327,111,165,1273,1324,0,0,65,0,49,0,324,67571
17031170900,660,579,81,72,588,563,17,0,21,0,52,7,197,63438
17031171000,2588,2404,184,279,2309,2135,208,15,127,13,60,30,444,75339
17031171100,1282,1158,124,82,1200,1085,32,0,67,0,82,16,375,63111
17031180100,2240,1803,437,151,2089,1676,32,0,235,0,283,14,827,51071
17031190100,829,654,175,180,649,418,5,0,15,0,360,31,666,37629
17031190200,1583,1377,206,257,1326,966,35,0,41,0,512,29,1146,59246
17031190300,1746,1462,284,300,1446,1245,92,23,37,0,327,22,864,55069
17031190401,1225,1038,187,148,1077,927,11,18,59,0,174,36,643,61383
17031190402,1696,1518,178,171,1525,1195,33,8,29,0,416,15,1014,51421
17031190601,1216,1037,179,98,1118,665,62,0,4,0,458,27,977,49091
17031190602,1422,1286,136,270,1152,776,39,29,36,0,512,30,1069,54464
17031190701,783,623,160,232,551,441,5,0,14,0,313,10,607,40298
17031190702,1448,1076,372,419,1029,857,138,0,0,0,453,0,1126,39882
17031190800,2008,1639,369,571,1437,1032,48,7,21,0,892,8,1559,47955
17031190900,714,513,201,229,485,330,72,8,0,0,272,32,558,55833
17031191000,723,559,164,189,534,422,32,0,16,0,238,15,594,50096
17031191100,2031,1683,348,523,1508,1043,138,12,33,0,763,42,1650,50666
17031191200,1025,831,194,203,822,433,49,6,7,7,518,5,948,50863
17031191301,1473,1224,249,406,1067,661,130,0,54,0,573,55,1166,49946
17031191302,1386,1220,166,272,1114,687,79,4,10,0,598,8,1135,46000
17031200100,1321,1151,170,127,1194,899,34,13,76,0,282,17,775,41131
17031200200,1638,1309,329,379,1259,787,106,41,10,0,676,18,1220,44077
17031200300,536,380,156,239,297,292,13,0,13,6,206,6,457,38571
17031200401,1018,839,179,320,698,511,93,31,0,0,372,11,812,42109
17031200402,1107,838,269,294,813,519,70,9,50,0,424,35,929,52482
17031210100,1419,1230,189,84,1335,1117,69,0,135,9,68,21,411,70234
17031210400,979,814,165,140,839,746,43,0,23,0,139,28,476,51141
17031210501,1252,990,262,282,970,921,116,22,16,0,131,46,559,47917
17031210502,1434,1082,352,241,1193,1099,94,12,12,0,186,31,784,52908
17031210601,915,798,117,84,831,708,0,18,48,0,102,39,454,66994
17031210602,1544,1327,217,299,1245,1189,58,0,33,0,173,91,706,59408
17031210700,1536,1284,252,320,1216,1312,20,0,66,0,94,44,757,64569
17031210800,384,371,13,20,364,310,0,0,0,0,64,10,153,61739
17031210900,1245,1090,155,131,1114,1030,21,0,81,0,91,22,373,72366
17031220300,891,816,75,24,867,787,10,0,31,0,24,39,240,88942
17031220400,1090,1018,72,66,1024,970,0,0,50,0,43,27,267,95333
17031220500,1194,1106,88,57,1137,1024,56,0,71,0,17,26,219,91389
17031220601,690,601,89,92,598,613,24,13,10,0,18,12,210,75438
17031220602,2460,2041,419,385,2075,2092,167,0,29,0,92,80,786,46276
17031220701,1068,948,120,146,922,814,33,0,15,0,153,53,633,65417
17031220702,1367,1209,158,161,1206,1055,91,0,26,0,164,31,679,61733
17031220901,984,726,258,260,724,697,94,0,26,0,119,48,636,47778
17031220902,946,822,124,163,783,821,6,8,16,0,64,31,686,56667
17031221000,1013,818,195,153,860,770,106,6,32,0,85,14,524,47344
17031221100,1931,1541,390,205,1726,1512,147,18,39,10,133,72,795,55194
17031221200,1226,1158,68,130,1096,1082,49,0,35,0,13,47,304,91354
17031221300,1315,1094,221,135,1180,1112,56,0,19,0,69,59,400,56725
17031221400,1347,1258,89,76,1271,1126,37,0,54,0,64,66,492,78972
17031221500,1325,1166,159,171,1154,1116,131,0,54,0,10,14,355,64495
17031221600,1413,1323,90,12,1401,1252,49,0,78,0,10,24,171,133438
17031222200,900,862,38,29,871,810,25,0,65,0,0,0,88,134500
17031222500,527,402,125,90,437,446,26,0,5,0,26,24,222,79250
17031222600,694,637,57,47,647,573,40,0,10,0,38,33,185,80735
17031222700,830,699,131,134,696,674,65,6,20,0,37,28,372,62733
17031222800,365,294,71,73,292,260,47,0,0,0,39,19,237,42039
17031222900,331,299,32,84,247,244,47,0,0,0,30,10,207,46985
17031230100,624,493,131,117,507,375,69,0,24,0,130,26,252,55000
17031230200,611,455,156,114,497,323,71,8,11,0,172,26,385,55605
17031230300,293,231,62,115,178,133,7,22,0,0,128,3,212,39653
17031230400,667,511,156,164,503,327,0,6,10,0,307,17,538,58250
17031230500,1152,757,395,473,679,296,138,0,30,0,679,9,954,31288
17031230600,1925,1430,495,671,1254,356,629,25,0,0,872,43,1185,41931
17031230700,1715,1388,327,477,1238,494,181,23,0,0,951,66,1367,40636
17031230800,357,282,75,89,268,126,19,3,0,0,195,14,312,55365
17031230900,1787,1281,506,423,1364,910,228,11,81,0,494,63,935,43438
17031231100,366,257,109,128,238,57,217,0,0,0,86,6,124,32895
17031231200,1920,1333,587,831,1089,124,1174,0,0,0,576,46,712,33627
17031231500,1808,1058,750,884,924,29,1583,0,0,0,196,0,245,31888
17031240200,796,701,95,86,710,677,17,0,48,0,25,29,140,128864
17031240300,581,550,31,42,539,501,14,0,35,0,0,31,27,124141
17031240500,1284,1241,43,40,1244,1137,30,0,98,0,9,10,48,156389
17031240600,612,579,33,25,587,532,44,0,0,0,13,23,142,105938
17031240700,669,557,112,67,602,562,48,0,10,0,33,16,301,76875
17031240800,619,488,131,87,532,437,65,0,13,0,62,42,274,48350
17031240900,491,333,158,148,343,270,52,0,41,0,100,28,222,37277
17031241000,720,548,172,170,550,530,88,0,29,0,62,11,298,65900
17031241100,1518,1271,247,236,1282,970,171,0,73,0,178,126,350,75658
17031241200,727,660,67,97,630,573,13,0,45,0,57,39,197,106339
17031241300,757,717,40,43,714,637,45,0,15,0,38,22,57,145938
17031241400,2464,2101,363,303,2161,2034,131,0,163,0,90,46,421,104167
17031241500,1346,1218,128,58,1288,1152,69,0,52,0,21,52,152,128125
17031241600,1622,1515,107,64,1558,1349,29,0,118,0,82,44,331,93583
17031242000,2110,1628,482,402,1708,1495,300,0,160,0,98,57,324,82778
17031242100,1701,1599,102,87,1614,1494,11,0,43,0,61,92,216,133951
17031242200,1617,1505,112,41,1576,1422,74,0,49,0,48,24,162,113618
17031242300,1589,1496,93,8,1581,1379,10,0,101,0,54,45,140,93980
17031242400,1290,1188,102,63,1227,1189,29,0,34,0,8,30,33,85000
17031242500,1525,1275,250,150,1375,1119,161,0,66,0,109,70,378,68036
17031242600,2504,2190,314,319,2185,2023,265,0,14,0,190,12,881,57362
17031242700,744,573,171,145,599,456,179,0,24,0,64,21,295,48333
17031242800,588,556,32,35,553,574,0,0,6,0,0,8,95,86806
17031242900,793,774,19,24,769,626,59,0,55,0,32,21,128,85917
17031243000,1030,986,44,45,985,827,31,0,35,0,101,36,244,77794
17031243100,907,805,102,98,809,751,12,0,66,0,63,15,189,107734
17031243200,890,825,65,41,849,764,32,0,36,0,51,7,176,123167
17031243300,1114,1047,67,24,1090,948,23,0,94,0,37,12,231,91071
17031243400,1293,1164,129,130,1163,1014,50,0,58,0,88,83,313,95764
17031243500,1790,1674,116,121,1669,1333,276,0,126,0,0,55,100,104423
17031250200,802,680,122,242,560,150,436,0,5,0,204,7,330,46250
17031250300,1532,1107,425,461,1071,190,1093,0,10,0,228,11,423,32225
17031250400,1831,1407,424,278,1553,157,1582,0,0,0,92,0,226,45479
17031250500,2775,2559,216,394,2381,1462,920,0,89,0,254,50,443,90058
17031250600,1343,1105,238,345,998,56,1179,0,10,0,98,0,120,43625
17031250700,2088,1663,425,694,1394,66,1833,0,0,0,171,18,227,40349
17031250800,790,555,235,256,534,33,639,0,4,0,114,0,133,32500
17031251000,341,251,90,117,224,17,280,0,0,0,44,0,48,37656
17031251100,1487,954,533,653,834,105,1304,0,0,0,78,0,146,22526
17031251200,1154,896,258,387,767,106,908,0,23,0,117,0,176,47875
17031251300,1375,1034,341,541,834,83,1182,0,0,0,103,7,165,29917
17031251400,1736,1301,435,514,1222,84,1587,0,0,0,28,37,63,30196
17031251500,1323,768,555,630,693,30,1256,0,0,0,37,0,86,22905
17031251600,1069,735,334,680,389,41,983,13,0,0,32,0,60,35264
17031251700,366,280,86,157,209,45,261,0,0,9,51,0,93,38000
17031251800,1634,1077,557,799,835,87,1494,0,0,0,22,31,49,22984
17031251900,1659,1003,656,664,995,46,1529,0,0,0,73,11,73,21281
17031252000,2289,1355,934,882,1407,15,2212,0,0,0,39,23,54,20611
17031252101,605,378,227,188,417,12,583,0,0,0,0,10,0,19023
17031252102,2191,1613,578,678,1513,19,2106,0,0,0,66,0,81,34829
17031252201,977,725,252,347,630,4,965,0,8,0,0,0,9,32051
17031252202,1509,940,569,796,713,28,1460,0,21,0,0,0,15,26230
17031260100,531,243,288,267,264,36,483,0,0,0,0,12,2,14303
17031260200,315,217,98,137,178,7,308,0,0,0,0,0,13,30114
17031260300,537,364,173,272,265,11,526,0,0,0,0,0,0,22236
17031260400,372,215,157,212,160,24,348,0,0,0,0,0,0,19697
17031260500,550,289,261,263,287,0,530,9,0,0,11,0,11,29286
17031260600,561,321,240,275,286,23,527,0,11,0,0,0,23,25625
17031260700,524,302,222,340,184,0,489,5,0,0,15,15,15,22339
17031260800,877,486,391,476,401,10,828,0,0,0,11,28,11,23944
17031260900,395,271,124,194,201,13,382,0,0,0,0,0,13,28750
17031261000,670,509,161,316,354,15,618,0,0,0,7,30,22,34000
17031270500,604,248,356,418,186,5,581,0,0,0,18,0,23,14453
17031271200,387,267,120,213,174,0,369,0,0,0,0,18,0,26984
17031271300,365,209,156,167,198,0,353,0,12,0,0,0,0,24340
17031271400,451,271,180,220,231,17,408,0,6,0,0,20,14,20759
17031271500,482,303,179,217,265,25,443,0,0,0,0,14,4,28846
17031271800,218,94,124,120,98,0,218,0,0,0,0,0,0,17905
17031280100,4096,3890,206,50,4046,2928,176,0,782,0,0,210,202,125708
17031280400,587,398,189,308,279,66,479,0,13,0,0,29,31,36698
17031280800,358,213,145,185,173,44,305,0,0,0,9,0,19,17143
17031280900,378,173,205,198,180,52,316,0,0,0,10,0,23,18269
17031281900,3527,2903,624,0,3527,1838,209,0,1382,0,0,98,213,102902
17031282700,769,667,102,115,654,313,284,0,103,0,54,15,197,80313
17031282800,663,542,121,71,592,280,164,16,98,0,90,15,178,54837
17031283100,1163,801,362,183,980,351,417,0,349,8,17,21,63,38798
17031283200,657,506,151,154,503,340,178,7,106,0,19,7,67,74890
17031283800,1658,1301,357,385,1273,742,647,0,233,0,24,12,190,74333
17031290900,1150,794,356,615,535,0,1150,0,0,0,0,0,0,28226
17031291200,777,419,358,457,320,14,746,0,0,0,17,0,17,23819
17031291600,300,218,82,41,259,202,35,0,10,0,53,0,224,47647
17031292200,890,487,403,522,368,54,825,0,0,0,11,0,29,32237
17031292400,609,397,212,215,394,36,573,0,0,0,0,0,5,31083
17031292500,1387,1067,320,639,748,70,1264,23,0,0,30,0,30,40131
17031300500,874,729,145,197,677,446,73,9,0,0,346,0,765,38113
17031300600,775,549,226,211,564,354,124,16,0,0,268,13,580,44492
17031300700,1293,941,352,391,902,679,15,11,8,0,570,10,1232,36224
17031300800,1103,669,434,553,550,615,0,0,0,0,488,0,1094,29949
17031300900,1278,813,465,445,833,576,27,10,0,0,637,28,1160,26833
17031301100,769,530,239,272,497,331,59,31,0,0,342,6,630,28723
17031301200,1141,817,324,512,629,494,130,34,24,0,435,24,939,27328
17031301600,1295,949,346,485,810,641,0,39,0,0,597,18,1248,35411
17031301701,1056,764,292,414,642,775,3,0,0,0,278,0,1042,29773
17031301702,1089,855,234,264,825,564,0,0,0,0,510,15,1050,39614
17031301801,1052,834,218,351,701,593,0,0,0,0,418,41,935,34427
17031301802,866,644,222,269,597,491,16,0,0,0,342,17,803,35925
17031301803,1348,995,353,459,889,807,23,0,0,0,483,35,1289,32308
17031310200,649,567,82,59,590,419,18,26,103,0,72,11,214,70428
17031310300,723,608,115,136,587,410,21,11,87,0,181,13,361,51576
17031310400,522,450,72,41,481,273,60,0,18,0,136,35,249,62614
17031310500,527,453,74,91,436,231,0,0,7,0,289,0,383,46875
17031310600,2022,1464,558,500,1522,1023,121,18,50,0,763,47,1351,35175
17031310700,523,390,133,86,437,269,43,0,13,0,178,20,346,44391
17031310800,1525,1306,219,236,1289,849,26,8,52,0,590,0,1160,52152
17031310900,1685,1294,391,283,1402,812,15,9,50,0,770,29,1362,41281
17031320100,8203,7659,544,0,8203,6528,238,131,1174,0,0,132,806,116909
17031320400,704,631,73,0,704,490,38,0,165,0,0,11,30,176000
17031320600,2829,2463,366,95,2734,1822,409,0,508,0,14,76,162,101679
17031330100,11517,10465,1052,1015,10502,6494,2752,0,1867,0,190,214,595,102303
17031330200,1859,1519,340,237,1622,772,694,9,336,0,0,48,11,77578
17031340300,699,427,272,183,516,150,7,0,503,0,31,8,45,26220
17031340400,683,531,152,114,569,157,20,0,495,0,11,0,25,45329
17031340500,852,529,323,240,612,448,23,7,339,0,35,0,54,26042
17031340600,430,172,258,243,187,0,414,0,0,0,0,16,0,12713
17031350100,1502,1140,362,64,1438,113,798,0,525,0,11,55,41,42018
17031350400,658,251,407,481,177,10,648,0,0,0,0,0,0,13587
17031351000,2267,1710,557,159,2108,123,1733,0,290,0,0,121,15,44727
17031351100,911,255,656,602,309,20,879,0,0,0,0,12,6,10455
17031351400,789,399,390,486,303,8,757,5,14,0,0,5,5,15997
17031351500,311,204,107,134,177,66,179,0,59,0,7,0,7,24063
17031360200,657,440,217,276,381,19,638,0,0,0,0,0,9,22242
17031380100,1052,597,455,521,531,16,997,11,0,0,0,28,10,17600
17031380200,1157,794,363,421,736,19,1100,0,9,0,8,21,8,23958
17031380500,330,177,153,215,115,0,326,0,4,0,0,0,0,20924
17031380700,437,335,102,159,278,14,412,0,0,0,0,11,6,41250
17031381200,958,730,228,258,700,63,895,0,0,0,0,0,0,27828
17031381400,691,552,139,203,488,7,663,0,21,0,0,0,0,33618
17031381500,176,115,61,91,85,14,162,0,0,0,0,0,11,30962
17031381700,0,0,0,0,0,0,0,0,0,0,0,0,0,-
17031381800,634,478,156,167,467,20,602,0,12,0,0,0,0,51607
17031381900,527,400,127,190,337,18,497,6,0,0,0,6,12,46750
17031390100,663,550,113,152,511,31,537,34,36,0,0,25,9,62574
17031390200,818,731,87,110,708,136,600,0,44,0,22,16,22,97786
17031390300,1516,988,528,513,1003,164,1278,0,9,0,0,65,32,22808
17031390400,1429,1049,380,428,1001,169,1220,0,11,0,0,29,0,24174
17031390500,753,578,175,84,669,215,498,0,34,0,0,6,35,49042
17031390600,794,641,153,119,675,390,340,0,26,0,0,38,13,63750
17031390700,3335,2765,570,124,3211,615,2120,0,428,0,36,136,89,59953
17031400300,612,396,216,300,312,19,561,0,13,0,0,19,26,35000
17031400400,780,616,164,304,476,18,762,0,0,0,0,0,0,35043
17031400500,762,515,247,297,465,12,735,7,0,0,0,8,12,27979
17031400800,1127,531,596,752,375,19,1036,52,0,0,0,20,9,20571
17031410100,1252,947,305,146,1106,505,562,0,72,0,38,75,123,43846
17031410200,673,498,175,54,619,331,167,10,138,0,13,14,65,40915
17031410500,1252,824,428,211,1041,470,630,0,107,0,10,35,20,51643
17031410600,1069,754,315,121,948,487,402,0,121,0,9,50,75,36734
17031410700,1030,698,332,26,1004,674,188,0,124,0,11,33,82,38852
17031410800,1761,1342,419,217,1544,648,656,39,307,0,33,78,112,42201
17031410900,1825,1528,297,120,1705,857,595,0,204,0,70,99,206,57188
17031411000,1846,1682,164,56,1790,951,735,0,56,0,29,75,90,70333
17031411100,829,747,82,6,823,640,34,0,129,0,0,26,21,111250
17031411200,718,564,154,59,659,477,80,0,140,0,2,19,33,84605
17031420100,755,475,280,383,372,28,700,0,8,0,0,19,18,19750
17031420200,606,392,214,235,371,130,414,0,48,0,7,7,14,37143
17031420300,722,547,175,154,568,132,535,0,38,0,0,17,32,39091
17031420400,711,335,376,268,443,140,459,0,92,0,5,15,38,12306
17031420500,799,630,169,243,556,0,795,0,4,0,0,0,0,37806
17031420600,933,508,425,415,518,26,864,0,0,0,12,31,30,23625
17031420700,1164,663,501,563,601,10,1095,26,0,0,33,0,22,18983
17031420800,814,556,258,377,437,32,752,0,8,0,0,22,35,34333
17031421200,480,276,204,256,224,0,462,0,0,0,14,4,14,20500
17031430101,1632,1005,627,844,788,30,1577,0,0,0,25,0,34,29750
17031430102,1891,1330,561,496,1395,34,1792,0,28,0,12,25,37,23740
17031430200,2379,1527,852,1113,1266,109,2270,0,0,0,0,0,56,22945
17031430300,931,463,468,460,471,23,901,0,7,0,0,0,7,17441
17031430400,1087,675,412,429,658,26,1049,0,0,0,0,12,0,29583
17031430500,1585,741,844,868,717,50,1512,0,0,0,0,23,13,18432
17031430600,753,577,176,231,522,45,667,0,0,0,15,26,30,30493
17031430700,1235,721,514,369,866,87,1091,45,0,0,0,12,0,19137
17031430800,686,524,162,110,576,42,624,0,0,0,20,0,14,44286
17031430900,681,455,226,192,489,0,669,0,0,0,0,12,0,41908
17031431200,1089,909,180,224,865,21,1018,0,0,0,0,50,9,49413
17031431301,1253,813,440,414,839,36,1157,0,0,0,36,24,36,21933
17031431302,1531,988,543,641,890,25,1467,0,0,0,31,8,52,31377
17031431400,3336,2330,1006,1151,2185,223,2952,0,0,0,15,146,31,28952
17031440101,1860,1186,674,935,925,23,1813,0,24,0,0,0,0,21856
17031440102,1593,1079,514,677,916,134,1409,0,0,16,24,10,36,28393
17031440201,2374,1626,748,986,1388,38,2293,0,0,0,0,43,0,26508
17031440202,1612,1200,412,425,1187,14,1588,0,10,0,0,0,41,30100
17031440300,1998,1609,389,577,1421,4,1994,0,0,0,0,0,0,53594
17031440600,741,644,97,132,609,0,741,0,0,0,0,0,0,71417
17031440700,607,534,73,161,446,38,564,0,0,0,0,5,0,37228
17031440800,705,424,281,343,362,13,679,0,13,0,0,0,0,25931
17031440900,932,689,243,472,460,0,913,12,0,0,0,7,0,30714
17031450300,1373,1197,176,293,1080,0,1323,0,0,0,0,50,0,44333
17031460100,1118,801,317,476,642,142,898,0,20,0,40,18,151,35000
17031460200,828,519,309,347,481,465,289,0,0,0,68,6,450,27976
17031460301,989,729,260,312,677,274,679,0,0,9,27,0,309,35845
17031460302,1146,835,311,493,653,75,1033,0,0,0,31,7,85,27391
17031460400,1204,983,221,364,840,56,1148,0,0,0,0,0,8,39605
17031460500,2364,2097,267,426,1938,10,2354,0,0,0,0,0,14,46162
17031460600,363,310,53,125,238,63,300,0,0,0,0,0,63,38315
17031460700,921,490,431,507,414,331,518,0,8,0,64,0,377,23972
17031461000,764,446,318,406,358,122,567,0,0,0,70,5,157,14511
17031470100,1046,766,280,359,687,11,1011,0,0,0,0,24,11,25287
17031480100,919,833,86,112,807,6,898,0,0,9,0,6,0,61495
17031480200,510,434,76,98,412,11,481,0,0,0,9,9,11,45441
17031480300,531,435,96,114,417,12,512,0,7,0,0,0,4,34107
17031480400,2188,1936,252,492,1696,45,2123,0,0,0,0,20,17,50426
17031480500,1100,907,193,310,790,131,935,0,8,0,19,7,129,40250
17031490300,882,746,136,188,694,0,865,0,0,0,6,11,3,55667
17031490400,337,312,25,52,285,0,337,0,0,0,0,0,0,51141
17031490500,719,590,129,234,485,5,686,0,0,0,0,28,5,54137
17031490600,556,467,89,215,341,6,543,0,7,0,0,0,0,39527
17031490700,895,702,193,323,572,0,895,0,0,0,0,0,4,39787
17031490800,1470,1165,305,430,1040,47,1390,0,14,0,0,19,0,40612
17031490901,1397,1074,323,532,865,0,1389,0,0,0,0,8,23,38693
17031490902,1850,1523,327,580,1270,11,1830,0,9,0,0,0,32,45273
17031491000,1112,661,451,687,425,0,1056,13,3,0,33,7,0,24727
17031491100,1386,1091,295,312,1074,0,1343,0,0,0,43,0,40,41167
17031491200,686,546,140,220,466,47,599,0,6,0,34,0,30,40167
17031491300,628,391,237,311,317,20,602,0,0,0,0,6,14,30000
17031491400,1130,767,363,615,515,22,1098,0,0,0,0,10,17,29737
17031500100,1547,1379,168,224,1323,22,1525,0,0,0,0,0,34,46517
17031500200,791,512,279,477,314,6,753,0,0,0,0,32,0,27247
17031500300,729,547,182,129,600,387,300,0,2,0,9,31,69,42263
17031510100,1016,706,310,328,688,763,157,0,0,0,96,0,710,36081
17031510200,1112,857,255,185,927,264,800,0,0,0,0,48,178,44423
17031510300,1947,1541,406,731,1216,18,1929,0,0,0,0,0,12,30069
17031520100,484,422,62,179,305,359,43,0,0,0,72,10,380,41875
17031520200,1075,785,290,447,628,832,111,9,0,0,104,19,870,38884
17031520300,1701,1275,426,468,1233,1449,45,18,0,0,143,46,1339,41860
17031520400,1303,1127,176,306,997,1145,46,0,0,0,90,22,981,44226
17031520500,1548,1379,169,181,1367,1343,46,23,0,0,118,18,894,62311
17031520600,795,675,120,101,694,741,0,0,0,0,48,6,528,44738
17031530100,759,533,226,349,410,340,349,8,0,0,62,0,404,35875
17031530200,1233,883,350,503,730,30,1194,0,0,0,0,9,0,36448
17031530300,1484,1229,255,385,1099,7,1453,10,0,0,0,14,7,47039
17031530400,737,631,106,213,524,11,720,0,6,0,0,0,0,58065
17031530501,1523,1196,327,510,1013,20,1455,0,0,0,11,37,11,44436
17031530502,518,417,101,198,320,0,518,0,0,0,0,0,0,44744
17031530503,1746,1307,439,603,1143,20,1689,0,0,0,0,37,11,39231
17031530600,950,717,233,429,521,11,909,0,0,0,0,30,5,32566
17031540101,1444,667,777,881,563,58,1379,0,7,0,0,0,58,14066
17031540102,1116,434,682,692,424,25,1080,0,0,0,0,11,11,13585
17031550100,2403,1845,558,465,1938,2071,190,0,0,0,105,37,1096,50637
17031550200,1055,972,83,65,990,935,71,0,0,0,49,0,403,53125
17031560100,342,297,45,57,285,165,29,5,41,0,102,0,226,62059
17031560200,621,519,102,143,478,119,428,0,0,0,63,11,132,48250
17031560300,952,831,121,180,772,641,19,0,48,0,185,59,494,51034
17031560400,455,394,61,46,409,336,6,3,20,0,90,0,280,55670
17031560700,1220,1098,122,150,1070,1016,0,0,0,0,204,0,538,56452
17031560800,2115,2019,96,134,1981,1775,21,16,0,0,264,39,777,70102
17031560900,1901,1854,47,48,1853,1676,0,0,0,0,178,47,526,96326
17031561000,2100,2049,51,99,2001,1923,18,0,0,0,124,35,596,99667
17031561100,1871,1759,112,206,1665,1586,6,0,0,0,247,32,617,84805
17031570100,415,356,59,59,356,263,6,8,33,0,100,5,233,55809
17031570200,610,506,104,94,516,443,0,0,54,0,103,10,351,43571
17031570300,1671,1398,273,399,1272,965,54,15,39,0,528,70,1123,44266
17031570400,528,504,24,60,468,340,0,5,10,10,163,0,406,41596
17031570500,712,624,88,72,640,445,8,0,43,0,216,0,472,40000
17031580100,806,678,128,165,641,293,44,36,204,0,196,33,486,41681
17031580200,922,710,212,292,630,421,0,0,102,0,362,37,747,43667
17031580300,701,615,86,198,503,324,17,21,80,0,247,12,545,45888
17031580400,1544,1213,331,277,1267,755,9,0,182,0,544,54,1201,41167
17031580501,1442,1102,340,360,1082,781,23,43,81,0,478,36,1141,39706
17031580502,1446,1180,266,279,1167,795,0,12,130,0,492,17,1074,40233
17031580600,1440,1234,206,237,1203,814,29,19,86,0,483,9,1169,46419
17031580700,1587,1315,272,594,993,867,43,0,96,0,500,81,1277,44986
17031580800,568,470,98,146,422,320,0,7,8,0,223,10,508,42946
17031590500,631,479,152,135,496,306,12,10,175,0,109,19,322,53295
17031590600,1178,981,197,319,859,561,10,19,109,0,352,127,692,40536
17031590700,1055,787,268,272,783,538,31,30,166,0,255,35,592,44906
17031600400,1581,1127,454,343,1238,552,57,0,813,0,149,10,233,34127
17031600600,1103,881,222,226,877,549,22,10,381,0,141,0,383,36005
17031600700,1064,882,182,211,853,628,82,28,230,0,96,0,305,35523
17031600900,1367,1242,125,139,1228,796,61,0,387,0,99,24,226,55018
17031610300,1670,1124,546,677,993,865,58,48,105,0,564,30,1381,33507
17031610400,583,371,212,183,400,294,7,5,0,0,271,6,550,35804
17031610800,540,499,41,102,438,484,0,7,9,0,8,32,99,49250
17031611000,293,148,145,152,141,74,177,0,5,0,37,0,100,19661
17031611100,753,539,214,289,464,428,143,0,0,0,164,18,570,25464
17031611200,767,547,220,304,463,375,164,5,0,0,206,17,564,28212
17031611300,853,642,211,320,533,537,94,0,0,0,222,0,696,26847
17031611400,946,719,227,243,703,603,9,70,0,0,232,32,878,32071
17031611500,937,616,321,302,635,595,122,0,0,0,209,11,747,35330
17031611600,531,400,131,232,299,198,214,0,1,0,92,26,282,32031
17031611700,554,361,193,252,302,189,248,0,0,0,88,29,292,25729
17031611800,674,511,163,348,326,148,396,0,0,0,130,0,259,34333
17031611900,555,365,190,250,305,52,441,0,0,0,51,11,95,25321
17031612000,427,349,78,225,202,28,394,0,5,0,0,0,21,30121
17031612100,354,276,78,198,156,6,331,0,0,0,11,6,17,24900
17031620100,1204,1091,113,174,1030,699,0,80,84,0,332,9,940,56339
17031620200,730,661,69,106,624,567,0,0,21,0,130,12,461,51333
17031620300,2038,1826,212,440,1598,1261,78,8,0,0,673,18,1361,54667
17031620400,1219,1060,159,211,1008,742,35,9,0,0,400,33,984,64861
17031630100,295,223,72,74,221,172,64,0,0,0,59,0,194,31750
17031630200,599,463,136,190,409,452,11,0,33,0,103,0,511,35707
17031630300,1249,1070,179,484,765,695,11,15,9,0,486,33,1137,52278
17031630400,1770,1341,429,591,1179,1085,34,0,0,0,651,0,1574,32683
17031630500,1536,1231,305,512,1024,883,25,0,0,0,628,0,1428,42434
17031630800,1713,1486,227,530,1183,673,97,0,0,0,928,15,1504,45046
17031630900,1281,1141,140,308,973,657,55,0,27,0,542,0,1100,46495
17031640100,486,421,65,74,412,394,15,6,5,0,61,5,217,44013
17031640300,2378,2250,128,181,2197,1781,16,50,0,0,417,114,1146,68397
17031640400,1207,1150,57,135,1072,990,46,0,10,0,123,38,317,68902
17031640500,1549,1462,87,209,1340,1260,28,0,34,0,185,42,566,83574
17031640600,1659,1391,268,267,1392,1272,35,0,13,0,321,18,640,44085
17031640700,1057,883,174,238,819,738,9,9,0,0,289,12,572,50625
17031640800,544,496,48,102,442,363,23,0,4,0,137,17,350,52381
17031650100,1268,1089,179,302,966,665,48,0,0,0,555,0,963,44722
17031650200,2104,1800,304,442,1662,1588,39,24,0,0,453,0,1520,48678
17031650301,1572,1486,86,233,1339,1101,10,0,25,0,389,47,1071,57875
17031650302,1074,917,157,209,865,641,32,11,0,0,383,7,876,47321
17031650400,1764,1504,260,299,1465,850,87,0,27,0,764,36,1410,48634
17031650500,1446,1270,176,160,1286,794,245,0,21,0,363,23,800,61972
17031660301,535,388,147,238,297,193,219,0,0,0,117,6,297,23976
17031660302,1482,1199,283,474,1008,591,429,0,19,0,432,11,931,32880
17031660400,1459,1219,240,494,965,711,106,0,0,0,636,6,1132,43772
17031660500,1353,1022,331,352,1001,717,158,8,0,0,463,7,1044,39137
17031660600,2076,1518,558,787,1289,497,1230,0,0,0,302,47,728,27423
17031660700,608,485,123,256,352,7,573,0,0,0,28,0,35,28125
17031660800,1663,1375,288,526,1137,328,990,0,18,0,273,54,538,36783
17031660900,1397,910,487,747,650,131,1109,0,5,0,56,96,135,28817
17031661000,1872,1324,548,590,1282,116,1696,0,0,0,35,25,130,31310
17031661100,1917,1591,326,431,1486,559,835,0,0,0,450,73,868,54425
17031670100,385,285,100,175,210,41,328,0,0,0,16,0,39,27450
17031670200,330,193,137,161,169,20,305,5,0,0,0,0,16,22143
17031670300,427,306,121,132,295,36,350,0,4,0,37,0,57,20938
17031670400,524,360,164,304,220,45,434,0,0,0,40,5,85,24667
17031670500,350,251,99,164,186,11,282,18,0,0,35,4,50,26200
17031670600,347,245,102,158,189,16,327,0,0,0,0,4,16,23021
17031670700,356,288,68,150,206,8,327,0,0,0,15,6,29,35074
17031670800,538,408,130,221,317,10,528,0,0,0,0,0,10,22219
17031670900,487,316,171,221,266,38,403,0,0,0,23,23,55,36875
17031671100,299,198,101,139,160,2,297,0,0,0,0,0,2,32426
17031671200,307,199,108,169,138,13,294,0,0,0,0,0,0,21699
17031671300,615,452,163,318,297,0,601,0,0,0,14,0,14,28466
17031671400,482,307,175,196,286,41,441,0,0,0,0,0,41,23636
17031671500,802,586,216,422,380,74,668,0,0,0,60,0,113,26822
17031671600,707,519,188,329,378,11,682,0,0,0,9,5,9,20919
17031671800,377,286,91,168,209,0,357,0,0,0,13,7,13,32163
17031671900,305,262,43,76,229,16,279,0,0,0,10,0,18,52625
17031672000,1157,891,266,418,739,20,1063,0,0,0,27,47,27,43063
17031680500,449,263,186,202,247,9,429,0,0,0,11,0,11,23675
17031680600,364,209,155,229,135,7,357,0,0,0,0,0,0,28304
17031680900,1720,962,758,905,815,10,1690,0,20,0,0,0,0,17295
17031681000,1116,536,580,606,510,12,1060,0,0,0,34,10,0,16064
17031681100,933,527,406,473,460,0,900,12,0,0,21,0,33,21266
17031681200,800,496,304,426,374,5,758,0,0,0,26,11,31,19662
17031681300,724,477,247,307,417,0,711,0,0,0,13,0,13,25927
17031681400,835,625,210,358,477,11,824,0,0,0,0,0,11,38385
17031690300,788,362,426,484,304,0,777,0,0,0,0,11,0,17310
17031690400,1371,847,524,574,797,0,1348,0,0,0,0,23,0,21106
17031690500,321,191,130,134,187,0,321,0,0,0,0,0,0,32546
17031690900,1669,1185,484,598,1071,26,1608,0,0,0,0,35,0,27554
17031691000,1109,875,234,219,890,0,1101,0,0,0,8,0,8,36806
17031691100,1071,612,459,570,501,0,1061,0,0,0,0,10,26,20469
17031691200,1081,758,323,404,677,22,1059,0,0,0,0,0,0,34657
17031691300,1066,741,325,357,709,0,1017,0,0,0,0,49,34,39853
17031691400,1266,955,311,515,751,0,1245,0,0,0,21,0,9,32935
17031691500,773,400,373,448,325,23,717,0,0,0,33,0,33,17292
17031700100,1068,911,157,235,833,157,769,0,0,0,133,9,230,62391
17031700200,1864,1692,172,231,1633,691,395,13,44,0,666,55,1082,64659
17031700301,1743,1592,151,317,1426,983,227,6,14,0,492,21,952,67765
17031700302,1759,1657,102,143,1616,994,380,0,0,0,338,47,778,68488
17031700401,1884,1566,318,456,1428,236,1248,11,30,0,303,56,425,68241
17031700402,1306,1076,230,262,1044,391,807,0,0,0,108,0,332,68935
17031700501,2416,2241,175,440,1976,106,2183,0,31,0,11,85,92,66886
17031700502,1040,949,91,42,998,93,907,0,0,0,8,32,15,95750
17031710100,489,277,212,182,307,11,467,0,0,0,6,5,17,19777
17031710200,1735,1252,483,626,1109,68,1667,0,0,0,0,0,0,28014
17031710300,539,391,148,185,354,0,461,24,0,0,21,33,26,35224
17031710400,1871,1337,534,650,1221,14,1836,0,0,0,21,0,14,35274
17031710500,1558,1187,371,484,1074,20,1476,0,9,0,22,31,43,32656
17031710600,652,464,188,239,413,4,626,0,0,0,22,0,0,32955
17031710700,1242,845,397,333,909,0,1231,0,0,0,0,11,11,19660
17031710800,1943,1444,499,615,1328,0,1881,25,37,0,0,0,0,31233
17031710900,774,512,262,316,458,15,741,0,0,0,12,6,21,30052
17031711000,1017,718,299,427,590,6,985,0,26,0,0,0,0,37628
17031711100,922,848,74,202,720,22,894,0,6,0,0,0,22,41985
17031711200,1969,1603,366,498,1471,3,1943,0,0,0,23,0,0,42596
17031711300,594,456,138,214,380,15,579,0,0,0,0,0,15,35086
17031711400,831,642,189,205,626,0,800,0,6,0,9,16,9,40777
17031711500,831,623,208,326,505,0,831,0,0,0,0,0,0,47022
17031720100,1179,1171,8,0,1179,781,363,0,9,0,26,0,77,152422
17031720200,1620,1462,158,67,1553,666,865,0,20,0,34,35,85,73300
17031720300,1354,1278,76,0,1354,847,461,0,20,0,26,0,87,122727
17031720400,671,654,17,24,647,616,29,0,3,0,23,0,38,98281
17031720500,782,752,30,4,778,747,25,0,10,0,0,0,52,119500
17031720600,611,578,33,20,591,431,169,0,5,0,0,6,6,110344
17031720700,1340,1251,89,80,1260,519,780,10,17,0,0,14,20,64656
17031730100,893,768,125,248,645,13,864,0,0,0,5,11,11,51313
17031730201,2272,1510,762,669,1603,19,2229,0,24,0,0,0,0,27500
17031730202,1127,972,155,155,972,15,1099,0,0,0,0,13,0,52046
17031730300,420,338,82,104,316,0,403,0,4,0,0,13,0,50556
17031730400,1358,1206,152,310,1048,18,1323,0,0,0,0,17,9,73077
17031730500,1517,1196,321,250,1267,8,1483,0,0,0,0,26,0,60755
17031730600,1179,945,234,238,941,13,1166,0,0,0,0,0,0,37207
17031730700,719,557,162,264,455,0,669,0,0,0,3,47,3,39893
17031740100,1153,1086,67,66,1087,1124,9,0,0,0,0,20,70,91924
17031740200,1915,1761,154,89,1826,1908,0,0,7,0,0,0,100,100361
17031740300,1807,1754,53,0,1807,1747,33,0,0,0,27,0,121,118640
17031740400,1876,1803,73,58,1818,1551,269,0,35,0,21,0,104,85798
17031750100,1384,1134,250,334,1050,9,1323,0,0,0,0,52,27,40692
17031750200,1258,1080,178,128,1130,414,831,8,0,0,5,0,45,78594
17031750300,932,894,38,33,899,821,96,0,5,0,10,0,35,93103
17031750400,1185,1105,80,28,1157,820,358,0,0,0,7,0,71,88224
17031750500,2068,1715,353,226,1842,515,1511,0,0,0,0,42,82,54896
17031750600,1257,858,399,391,866,23,1220,0,0,0,0,14,0,37159
17031760801,2128,1873,255,228,1900,1364,129,0,420,0,141,74,254,60291
17031760802,1123,1002,121,112,1011,1055,19,0,19,0,21,9,30,52188
17031760803,2818,2464,354,315,2503,2455,44,0,217,0,39,63,183,41342
17031770201,2780,2579,201,206,2574,2306,47,0,280,0,76,71,243,62853
17031770202,2135,2062,73,97,2038,1973,0,0,33,0,129,0,157,65514
17031770300,2816,2748,68,71,2745,2536,60,0,178,0,18,24,210,81938
17031770400,1792,1601,191,156,1636,1437,80,0,151,7,80,37,326,68984
17031770500,1095,796,299,225,870,950,0,10,0,0,120,15,819,42399
17031770601,1051,979,72,120,931,871,0,0,134,0,36,10,58,72946
17031770602,1556,1292,264,196,1360,1153,62,0,142,0,192,7,617,63112
17031770700,1095,998,97,73,1022,1057,13,0,9,0,16,0,120,59526
17031770800,1981,1797,184,236,1745,1857,16,0,14,0,76,18,285,58909
17031770901,2052,1857,195,110,1942,1897,10,0,145,0,0,0,99,69321
17031770902,1404,1315,89,61,1343,1280,13,0,63,0,48,0,107,60000
17031800100,875,856,19,7,868,829,0,0,46,0,0,0,0,"250,000+"
17031800200,2359,2254,105,36,2323,2238,91,0,30,0,0,0,72,194803
17031800300,1219,1178,41,23,1196,1166,0,0,26,0,11,16,21,204148
17031800400,1240,1177,63,0,1240,1159,0,0,50,0,0,31,26,"250,000+"
17031800500,1670,1610,60,0,1670,1607,0,8,45,0,0,10,35,211042
17031800600,753,705,48,7,746,704,4,0,31,0,0,14,25,214875
17031800700,1648,1622,26,0,1648,1518,8,0,115,0,0,7,61,196371
17031800800,979,913,66,14,965,865,9,0,105,0,0,0,33,93906
17031800900,1445,1413,32,45,1400,1061,20,0,364,0,0,0,44,125404
17031801000,1931,1791,140,51,1880,1601,9,0,285,0,10,26,36,113299
17031801100,1613,1585,28,19,1594,1463,0,0,124,0,0,26,18,162328
17031801200,1296,1222,74,0,1296,1237,0,0,51,0,0,8,17,194423
17031801300,1646,1540,106,100,1546,1495,21,0,130,0,0,0,20,165139
17031801400,1040,1009,31,0,1040,867,10,0,163,0,0,0,20,131944
17031801500,2410,2339,71,130,2280,2123,65,29,193,0,0,0,0,103548
17031801601,1775,1692,83,19,1756,1539,0,0,220,0,9,7,20,109886
17031801603,1579,1354,225,51,1528,1120,87,0,301,0,35,36,200,50293
17031801605,2216,2202,14,29,2187,1956,0,0,248,0,0,12,59,138992
17031801606,2506,2322,184,30,2476,2153,0,0,325,0,0,28,0,111912
17031801607,2070,1936,134,36,2034,1470,9,0,567,0,0,24,63,84022
17031801608,2887,2791,96,0,2887,2259,13,0,581,0,0,34,41,119766
17031801701,1237,1214,23,9,1228,1111,0,0,112,0,14,0,24,165972
17031801702,1691,1639,52,8,1683,1536,0,0,144,0,0,11,46,109821
17031801800,2350,2183,167,33,2317,2106,0,0,229,0,0,15,22,140789
17031801901,1828,1710,118,55,1773,1662,0,6,141,0,11,8,210,92727
17031801902,1136,1099,37,7,1129,1025,15,0,90,0,0,6,6,150862
17031802002,1644,1601,43,20,1624,1449,22,0,141,0,32,0,69,118542
17031802003,870,847,23,38,832,709,14,0,127,0,3,17,132,99881
17031802004,2109,1794,315,243,1866,1398,78,0,618,0,15,0,149,45045
17031802100,1148,1074,74,25,1123,995,0,0,117,0,0,36,19,149286
17031802200,1883,1821,62,6,1877,1800,29,0,54,0,0,0,38,113750
17031802300,2257,2045,212,61,2196,1897,15,0,344,0,0,1,72,112969
17031802402,2096,1759,337,263,1833,1490,98,0,158,25,271,54,461,60833
17031802403,834,805,29,51,783,746,3,0,63,0,0,22,10,67917
17031802404,2695,2397,298,288,2407,1718,56,41,431,19,416,14,760,59258
17031802503,2403,2108,295,236,2167,1752,0,38,478,0,75,60,158,77006
17031802504,2075,1939,136,204,1871,1526,19,8,209,8,294,11,647,85388
17031802505,2366,1978,388,554,1812,1366,140,0,479,0,364,17,681,56698
17031802506,790,729,61,72,718,530,9,8,89,0,129,25,298,83333
17031802605,2771,2660,111,138,2633,2239,0,0,479,0,12,41,57,94921
17031802607,479,474,5,5,474,455,0,0,24,0,0,0,34,112813
17031802608,3009,2767,242,110,2899,2816,24,0,124,0,32,13,72,58212
17031802609,2428,2239,189,396,2032,1369,77,0,370,0,574,38,838,54248
17031802610,635,625,10,24,611,555,0,0,70,0,6,4,10,90529
17031802701,2204,2126,78,217,1987,1701,16,13,345,14,115,0,273,90106
17031802702,1778,1615,163,93,1685,1409,9,0,291,0,29,40,66,84875
17031802801,1867,1783,84,45,1822,1667,29,0,110,0,52,9,85,102520
17031802802,2296,2153,143,17,2279,1972,26,24,191,0,63,20,146,102045
17031802900,2052,1989,63,0,2052,1967,0,0,63,0,0,22,22,130909
17031803005,1082,968,114,86,996,964,20,0,69,0,29,0,55,67222
17031803007,1996,1948,48,106,1890,1692,28,0,201,0,58,17,95,105991
17031803008,1667,1587,80,65,1602,1515,20,0,104,0,23,5,63,108068
17031803010,1988,1901,87,28,1960,1706,18,0,163,0,101,0,165,111042
17031803012,933,883,50,105,828,791,0,15,69,0,24,34,120,75417
17031803013,2207,2054,153,119,2088,1918,14,0,97,16,132,30,149,78125
17031803014,1357,1259,98,128,1229,1146,23,0,102,0,86,0,212,65243
17031803015,1902,1791,111,87,1815,1663,95,0,144,0,0,0,81,78600
17031803016,912,897,15,25,887,409,0,0,471,0,9,23,21,98571
17031803017,2665,2577,88,146,2519,2051,22,0,335,0,203,54,310,90799
17031803100,1221,1125,96,23,1198,1182,0,0,25,0,0,14,22,117772
17031803200,2332,2230,102,29,2303,2195,37,0,100,0,0,0,91,83491
17031803300,2758,2458,300,223,2535,2369,22,0,274,0,62,31,184,97353
17031803400,2232,2097,135,93,2139,2111,0,0,97,0,10,14,62,116667
17031803500,2248,2084,164,25,2223,2202,0,0,46,0,0,0,0,105114
17031803603,2319,2266,53,69,2250,1796,33,0,450,0,0,40,0,157125
17031803604,1845,1780,65,100,1745,1597,28,0,140,0,58,22,128,69417
17031803605,2647,2366,281,336,2311,2129,47,0,333,0,138,0,313,95089
17031803606,2776,2315,461,375,2401,1299,93,31,227,0,1109,17,1295,54513
17031803607,1846,1821,25,9,1837,1649,0,0,85,0,55,57,135,109929
17031803608,2849,2539,310,313,2536,2155,145,0,285,0,210,54,284,67773
17031803610,3193,2893,300,147,3046,2372,174,0,391,0,110,146,281,65639
17031803611,2037,1871,166,221,1816,1192,137,0,133,0,420,155,742,65889
17031803612,1228,956,272,226,1002,872,38,18,118,0,174,8,487,55278
17031803701,1378,1275,103,96,1282,1164,9,0,102,0,92,11,110,91122
17031803702,2611,2513,98,93,2518,2277,31,0,188,0,20,95,147,90685
17031803800,1762,1657,105,79,1683,1526,22,8,87,0,66,53,139,84615
17031803901,1761,1642,119,65,1696,1557,19,15,107,0,22,41,67,66347
17031803902,1275,1213,62,16,1259,1123,0,0,19,0,105,28,168,91010
17031804000,1870,1793,77,60,1810,1631,44,0,90,0,88,17,215,72627
17031804102,2530,2498,32,18,2512,2195,13,0,322,0,0,0,39,132222
17031804104,1775,1715,60,41,1734,1340,32,0,368,0,0,35,57,116563
17031804105,1255,1211,44,0,1255,1076,0,0,152,0,0,27,6,123594
17031804106,2743,2637,106,77,2666,2038,34,16,576,0,47,32,140,111635
17031804108,1900,1814,86,121,1779,921,145,14,702,16,49,53,153,85000
17031804109,1080,1042,38,35,1045,864,64,0,103,0,35,14,62,110833
17031804201,2788,2602,186,69,2719,2174,0,0,569,22,23,0,87,148670
17031804202,2594,2432,162,236,2358,2100,0,0,420,0,74,0,103,122931
17031804305,2404,2294,110,242,2162,1844,104,0,213,0,227,16,501,75682
17031804306,1695,1574,121,241,1454,1115,31,10,79,0,445,15,637,64310
17031804308,2436,2312,124,188,2248,1504,154,0,426,0,269,83,493,72073
17031804309,940,893,47,86,854,621,51,0,65,0,170,33,288,87742
17031804310,3137,3019,118,171,2966,2431,60,0,486,0,121,39,509,95439
17031804311,2673,2517,156,143,2530,1570,82,25,664,0,302,30,505,97420
17031804403,2430,2145,285,142,2288,1706,119,58,259,12,221,55,699,75417
17031804404,1534,1423,111,134,1400,944,27,0,108,0,442,13,750,69559
17031804405,1071,949,122,204,867,487,147,20,157,0,260,0,499,59397
17031804406,2002,1862,140,224,1778,1321,107,10,190,0,358,16,824,62727
17031804505,1396,1226,170,108,1288,1208,57,11,77,0,32,11,190,67907
17031804506,1715,1691,24,80,1635,1417,17,11,200,0,38,32,158,95265
17031804507,4204,4008,196,136,4068,3090,112,0,719,0,200,83,355,97684
17031804508,735,598,137,168,567,438,60,5,99,0,117,16,225,62063
17031804509,1621,1542,79,189,1432,928,21,0,177,0,462,33,795,74792
17031804510,1491,1234,257,272,1219,724,48,4,33,0,656,26,999,63422
17031804511,755,626,129,111,644,415,53,5,103,0,179,0,378,58650
17031804603,2651,2507,144,220,2431,1576,113,0,614,0,256,92,387,64721
17031804606,2500,2437,63,57,2443,2009,35,0,391,0,45,20,132,104968
17031804607,2396,2280,116,157,2239,1954,47,0,280,0,23,92,131,97969
17031804608,1424,1296,128,72,1352,1021,38,0,283,0,53,29,110,85040
17031804609,2288,2204,84,34,2254,1456,14,25,724,0,18,51,64,95315
17031804610,1146,1069,77,57,1089,892,20,0,208,0,0,26,28,72037
17031804611,1804,1753,51,57,1747,1533,38,7,185,0,0,41,88,83889
17031804701,2475,2253,222,166,2309,1319,235,0,624,0,253,44,335,62756
17031804705,1569,1443,126,114,1455,1000,106,13,234,0,204,12,281,63301
17031804706,771,761,10,49,722,606,7,0,92,0,53,13,69,119327
17031804709,2436,2260,176,184,2252,1616,132,0,423,0,229,36,378,62179
17031804710,1509,1455,54,94,1415,1268,35,12,124,0,51,19,79,78317
17031804711,2937,2695,242,237,2700,1590,210,19,911,0,182,25,340,69365
17031804712,1815,1747,68,66,1749,1322,124,0,280,0,82,7,142,95949
17031804713,2063,1864,199,171,1892,1005,58,18,840,0,123,19,179,89185
17031804714,1252,1176,76,82,1170,1027,0,14,157,0,23,31,89,76959
17031804715,1056,947,109,218,838,428,47,0,308,0,257,16,348,50373
17031804716,1599,1533,66,148,1451,933,44,13,524,0,51,34,147,95527
17031804803,2073,2045,28,180,1893,1506,95,17,383,0,46,26,188,81118
17031804804,2502,2297,205,182,2320,1685,196,46,399,0,176,0,301,79351
17031804805,2420,2342,78,66,2354,1920,115,0,288,0,65,32,167,83662
17031804806,1101,1031,70,65,1036,842,37,0,51,0,138,33,270,73313
17031804807,1739,1636,103,127,1612,1360,31,0,194,0,143,11,216,80957
17031804808,818,789,29,16,802,677,4,9,70,0,53,5,81,107174
17031804809,1434,1336,98,20,1414,1217,45,0,145,0,0,27,7,99643
17031804810,2457,2209,248,194,2263,1945,55,0,348,34,75,0,217,73136
17031804901,2468,2413,55,38,2430,2298,16,0,78,0,15,61,31,102379
17031804902,1858,1696,162,73,1785,1710,0,0,114,0,0,34,174,83876
17031805001,1781,1719,62,52,1729,1757,0,0,7,0,6,11,108,102135
17031805002,2832,2574,258,522,2310,1868,162,59,453,0,180,110,448,48029
17031805105,2539,2280,259,263,2276,1650,116,0,417,22,334,0,706,54572
17031805106,1203,1059,144,56,1147,1044,38,0,114,0,0,7,14,71979
17031805107,2857,2605,252,374,2483,1753,255,0,419,0,339,91,793,49161
17031805108,2458,2299,159,154,2304,1466,199,75,506,0,212,0,562,58904
17031805109,1658,1460,198,207,1451,1443,67,0,148,0,0,0,41,87889
17031805110,1938,1775,163,106,1832,1793,8,0,128,0,0,9,17,76350
17031805111,2788,2520,268,498,2290,2043,106,0,443,0,136,60,786,61052
17031805112,1285,1163,122,125,1160,1023,41,0,190,0,31,0,147,52150
17031805201,1164,1136,28,41,1123,925,0,0,184,0,0,55,61,101552
17031805202,1612,1468,144,69,1543,1312,19,11,242,0,11,17,69,83894
17031805301,1119,1001,118,138,981,756,90,0,231,0,20,22,31,64331
17031805302,1275,1190,85,113,1162,870,9,0,328,0,0,68,22,88287
17031805401,1357,1193,164,99,1258,1177,33,0,111,0,8,28,75,79958
17031805402,1790,1641,149,38,1752,1569,34,1,132,0,37,17,82,71044
17031805501,1492,1403,89,36,1456,1406,0,0,50,19,17,0,123,92500
17031805502,1541,1462,79,7,1534,1484,0,0,48,0,9,0,36,125764
17031805600,1496,1460,36,13,1483,1428,0,0,68,0,0,0,14,134167
17031805701,1951,1886,65,7,1944,1857,0,0,51,0,43,0,166,113576
17031805702,703,689,14,35,668,690,0,0,6,0,0,7,0,115417
17031805801,989,945,44,37,952,947,8,0,26,0,0,8,38,95489
17031805802,1881,1808,73,23,1858,1835,0,0,26,0,0,20,137,90504
17031805901,1813,1703,110,63,1750,1570,7,0,202,0,7,27,143,81250
17031805902,2069,1958,111,73,1996,1823,0,0,231,0,0,15,52,103417
17031806001,2330,2031,299,256,2074,1249,136,64,771,0,41,69,230,49912
17031806002,2632,2157,475,410,2222,1531,93,0,898,0,61,49,234,60682
17031806003,2881,2578,303,329,2552,1574,25,0,1226,0,39,17,203,62859
17031806004,2703,2308,395,360,2343,1969,37,0,618,0,42,37,329,47274
17031806102,1379,1238,141,176,1203,1124,14,0,205,0,36,0,153,89139
17031806103,1768,1719,49,85,1683,1558,0,10,154,5,28,13,154,90000
17031806104,1752,1459,293,554,1198,820,319,22,472,0,99,20,123,49967
17031806201,2301,2081,220,200,2101,1936,32,0,284,0,49,0,331,48151
17031806202,2465,2117,348,239,2226,2224,84,0,134,0,4,19,173,49359
17031806300,1687,1572,115,41,1646,1552,44,0,62,10,5,14,218,84974
17031806400,845,705,140,68,777,812,4,3,21,0,5,0,79,84250
17031806501,726,633,93,109,617,447,39,8,137,0,85,10,128,51667
17031806502,1463,1368,95,84,1379,1211,33,0,80,0,90,49,350,71359
17031806600,1290,1214,76,99,1191,1061,12,0,147,0,70,0,292,82708
17031806700,1470,1434,36,53,1417,1217,78,0,122,0,34,19,87,114167
17031806801,1413,1212,201,125,1288,952,65,0,267,0,33,96,48,63580
17031806802,1083,1043,40,64,1019,584,134,5,348,0,0,12,58,76295
17031806900,2217,1975,242,359,1858,1440,37,0,614,0,0,126,187,75186
17031807000,2007,1764,243,213,1794,1223,216,0,499,0,42,27,226,60542
17031807100,1186,1146,40,30,1156,920,134,0,117,0,9,6,39,118971
17031807200,1792,1690,102,159,1633,1109,205,0,383,0,8,87,107,92547
17031807300,2820,2388,432,346,2474,1694,232,17,738,0,0,139,240,58958
17031807400,2158,1883,275,268,1890,1380,170,0,498,18,33,59,280,53734
17031807500,1077,1066,11,38,1039,736,32,0,276,0,8,25,46,112565
17031807600,1979,1813,166,191,1788,1133,168,0,576,0,4,98,156,68815
17031807700,2139,1757,382,279,1860,1632,58,0,391,0,47,11,195,49009
17031807800,829,799,30,50,779,623,3,0,175,0,17,11,83,104875
17031807900,1346,1247,99,17,1329,1095,0,0,242,0,9,0,51,105132
17031808001,1227,1138,89,53,1174,809,34,0,328,0,9,47,64,100549
17031808002,1687,1547,140,99,1588,1158,20,0,435,0,13,61,116,77240
17031808100,1639,1469,170,71,1568,1509,0,11,86,0,10,23,98,50291
17031808200,1841,1687,154,217,1624,1395,33,15,371,0,17,10,163,70169
17031808301,2348,2128,220,119,2229,1582,60,0,624,0,51,31,136,78828
17031808302,1468,1401,67,106,1362,977,55,6,406,0,7,17,86,78250
17031808400,1445,1401,44,75,1370,1039,32,0,329,0,26,19,58,83634
17031808500,1307,1215,92,39,1268,973,12,0,271,0,28,23,58,94471
17031808600,703,685,18,21,682,668,0,0,29,0,4,2,15,170313
17031808702,401,330,71,4,397,328,4,0,58,0,0,11,8,68542
17031808800,1389,1286,103,0,1389,1208,55,0,108,0,0,18,18,134583
17031808900,1624,1547,77,12,1612,1532,0,0,68,0,20,4,30,141250
17031809000,1512,1456,56,8,1504,1351,53,0,60,0,17,31,22,138966
17031809100,1405,1338,67,14,1391,1257,77,0,61,0,0,10,18,106815
17031809200,1500,1077,423,322,1178,439,872,0,47,0,76,66,320,48648
17031809300,1656,974,682,85,1571,1147,217,0,260,0,15,17,84,36406
17031809400,2626,2069,557,16,2610,2014,62,0,509,0,41,0,193,52283
17031809500,1931,1557,374,66,1865,1431,180,0,274,0,0,46,131,65685
17031809600,1044,909,135,140,904,496,455,0,27,0,42,24,145,90625
17031809700,1163,1096,67,72,1091,670,338,0,33,0,53,69,120,83036
17031809800,1034,867,167,51,983,903,54,0,42,0,18,17,74,101364
17031809900,1323,1288,35,19,1304,1149,39,0,117,0,0,18,80,122083
17031810000,2712,2474,238,47,2665,2361,67,0,173,0,47,64,147,90185
17031810100,2029,1857,172,181,1848,1510,335,0,109,0,64,11,121,69436
17031810200,2564,2389,175,324,2240,1478,734,0,146,0,104,102,292,61743
17031810301,1475,1308,167,139,1336,863,531,0,46,0,24,11,270,76910
17031810302,1136,1059,77,60,1076,700,311,0,70,0,39,16,52,77162
17031810400,1995,1880,115,35,1960,1939,0,0,47,0,0,9,110,105598
17031810501,1844,1714,130,81,1763,1750,0,11,54,0,10,19,132,73429
17031810502,1863,1706,157,199,1664,1683,0,0,117,0,36,27,149,54172
17031810600,1847,1590,257,78,1769,1566,46,0,177,0,58,0,224,54525
17031810701,1854,1503,351,298,1556,1708,30,0,36,0,70,10,623,43587
17031810702,1474,1260,214,327,1147,1207,9,17,57,0,164,20,514,50707
17031810800,1700,1602,98,125,1575,1515,18,0,77,0,79,11,276,73462
17031810900,2562,2385,177,208,2354,2036,192,0,99,0,220,15,717,52871
17031811000,1642,1510,132,27,1615,1473,32,0,94,0,27,16,131,80208
17031811100,2471,2173,298,278,2193,2265,0,0,0,0,175,31,437,48672
17031811200,1760,1589,171,206,1554,1581,22,0,34,0,104,19,400,63495
17031811301,1437,1273,164,200,1237,1200,69,0,13,0,112,43,793,66655
17031811302,1086,810,276,246,840,693,114,19,9,0,248,3,622,40511
17031811401,1741,1582,159,243,1498,1399,28,5,87,0,183,39,585,65269
17031811402,1477,1359,118,89,1388,1287,0,15,79,0,69,27,548,62014
17031811500,2027,1892,135,121,1906,1817,0,0,24,0,158,28,647,72011
17031811600,2310,1914,396,243,2067,1939,20,22,106,0,130,93,438,50703
17031811701,1203,987,216,256,947,895,33,0,26,0,244,5,713,54691
17031811702,1630,1375,255,203,1427,1131,64,22,59,0,328,26,694,50663
17031811800,1488,1324,164,243,1245,1302,30,0,6,0,131,19,655,77566
17031811900,1871,1774,97,46,1825,1636,127,0,60,0,36,12,96,126250
17031812000,2094,2033,61,20,2074,1864,127,0,56,0,12,35,37,117941
17031812100,1535,1441,94,56,1479,985,491,8,35,0,16,0,91,125590
17031812200,1296,1256,40,34,1262,1083,123,0,36,0,31,23,67,228229
17031812301,2335,2147,188,48,2287,1543,424,0,213,0,59,96,249,82218
17031812302,977,885,92,42,935,760,156,0,46,0,0,15,64,139189
17031812400,1099,1071,28,9,1090,1015,28,0,56,0,0,0,0,187917
17031812500,1550,1274,276,199,1351,885,543,0,61,0,38,23,59,62500
17031812600,1759,1481,278,69,1690,984,502,0,180,0,38,55,128,56415
17031812700,1546,1394,152,188,1358,1054,256,0,83,0,71,82,178,62800
17031812801,1791,1473,318,283,1508,1249,404,0,81,0,25,32,92,62054
17031812802,1293,1169,124,111,1182,933,213,0,72,0,23,52,76,55179
17031812900,1727,1599,128,122,1605,1455,187,0,69,0,7,9,80,111607
17031813000,1414,1316,98,63,1351,1021,319,0,12,0,29,33,133,104792
17031813100,1810,1668,142,95,1715,1216,365,0,113,0,33,83,68,91250
17031813200,1552,1471,81,133,1419,1228,178,0,80,0,28,38,58,130880
17031813301,864,660,204,279,585,244,61,0,0,0,559,0,769,40536
17031813302,877,687,190,212,665,323,58,0,0,0,496,0,777,48233
17031813400,1893,1476,417,443,1450,653,109,11,0,0,1052,68,1567,52274
17031813500,1850,1594,256,406,1444,710,88,0,24,0,966,62,1530,55168
17031813600,1441,1140,301,364,1077,408,21,0,21,0,969,22,1320,51086
17031813701,971,746,225,334,637,390,95,20,0,0,466,0,823,41707
17031813702,1073,816,257,244,829,240,167,0,10,0,656,0,879,42123
17031813801,754,659,95,149,605,289,0,6,6,0,453,0,708,48088
17031813802,1413,1190,223,405,1008,521,58,10,42,0,768,14,1127,41044
17031813900,1570,1246,324,442,1128,694,65,0,16,0,785,10,1257,43571
17031814000,1343,1148,195,302,1041,688,47,9,0,0,592,7,1075,46225
17031814100,1235,1022,213,269,966,432,112,0,10,0,644,37,1027,42176
17031814200,1909,1597,312,526,1383,828,51,0,0,0,1008,22,1647,41533
17031814300,1309,1036,273,381,928,510,31,27,14,0,717,10,1163,44440
17031814400,2275,1858,417,578,1697,1243,43,4,18,0,923,44,1572,44867
17031814500,1449,1382,67,202,1247,719,29,9,0,0,692,0,1117,65638
17031814600,1673,1380,293,330,1343,1167,164,0,28,0,249,65,911,63814
17031814700,1587,1410,177,302,1285,1154,19,0,76,0,276,62,834,66771
17031814800,2031,1888,143,259,1772,927,425,14,119,0,546,0,933,53072
17031814900,2331,1916,415,578,1753,1450,466,0,36,0,365,14,1038,56663
17031815000,1267,1131,136,269,998,637,121,16,30,0,415,48,761,58015
17031815100,1317,1175,142,279,1038,674,71,4,55,0,500,13,818,65182
17031815200,2185,1872,313,366,1819,1141,151,39,48,0,767,39,1297,60687
17031815300,1266,1164,102,189,1077,750,31,0,73,0,348,64,588,69167
17031815400,2018,1786,232,250,1768,1533,77,0,43,0,282,83,646,53393
17031815500,2550,2276,274,265,2285,1456,34,0,17,0,878,165,1457,62167
17031815600,1917,1737,180,336,1581,1578,65,0,20,0,227,27,479,63383
17031815701,1295,1254,41,33,1262,1229,9,4,10,0,22,21,130,125486
17031815702,1910,1758,152,141,1769,1817,45,0,48,0,0,0,196,91607
17031815800,555,466,89,28,527,531,0,0,8,0,16,0,50,86458
17031815900,2900,2501,399,428,2472,1521,1052,16,186,0,0,125,117,52642
17031816000,1604,1435,169,87,1517,1092,364,0,119,0,18,11,56,71389
17031816100,2611,2376,235,297,2314,1580,698,14,147,0,81,91,189,59485
17031816200,1550,1280,270,127,1423,1016,298,0,48,0,183,5,461,52357
17031816300,1602,1457,145,245,1357,1145,38,0,7,0,402,10,967,67905
17031816401,1362,1156,206,315,1047,723,34,0,0,0,595,10,1094,54274
17031816402,1162,1039,123,125,1037,701,45,11,0,0,405,0,851,47976
17031816500,1321,1017,304,334,987,898,57,0,0,0,361,5,880,40632
17031816600,1189,987,202,361,828,564,43,0,47,0,493,42,955,57880
17031816700,809,656,153,158,651,522,73,0,22,0,188,4,507,48381
17031816800,1870,1707,163,231,1639,1168,513,9,37,0,120,23,438,60857
17031816900,1750,1563,187,405,1345,305,1166,0,21,0,243,15,480,61484
17031817000,1706,1533,173,256,1450,214,1360,10,0,0,122,0,258,52200
17031817101,1720,1418,302,431,1289,76,1503,0,38,0,78,25,90,46234
17031817102,1064,911,153,205,859,125,882,0,0,0,30,27,73,63141
17031817200,1580,1351,229,532,1048,112,1274,0,0,0,98,96,231,50167
17031817300,814,475,339,261,553,61,629,0,0,0,117,7,163,31500
17031817400,1115,923,192,322,793,386,344,0,8,0,331,46,547,59926
17031817500,1290,938,352,556,734,66,1117,0,43,0,64,0,101,32900
17031817600,1236,1108,128,405,831,116,1043,0,0,0,64,13,159,46591
17031817700,1655,1462,193,407,1248,197,1399,0,9,0,50,0,189,61250
17031817900,2432,2107,325,617,1815,422,1937,0,73,0,0,0,43,47847
17031818000,1534,1340,194,254,1280,710,605,0,157,0,13,49,176,60066
17031818100,847,802,45,40,807,634,115,0,42,0,48,8,141,91023
17031818200,1689,1532,157,189,1500,978,472,8,42,0,97,92,318,70790
17031818300,2011,1875,136,363,1648,789,925,0,20,0,247,30,484,54597
17031818401,1321,1231,90,85,1236,828,317,0,60,0,99,17,246,76042
17031818402,1386,1267,119,28,1358,978,261,0,32,0,80,35,146,63243
17031818500,2412,2262,150,53,2359,2042,124,0,123,0,102,21,224,85958
17031818600,1895,1764,131,220,1675,1635,129,0,78,0,27,26,212,86331
17031818700,1337,1219,118,108,1229,1255,32,8,9,0,33,0,161,84417
17031818800,2108,2065,43,83,2025,1980,29,0,32,0,17,50,135,84053
17031818900,1820,1726,94,61,1759,1667,74,0,30,0,38,11,159,77711
17031819000,1551,1464,87,11,1540,1533,0,0,0,0,8,10,53,135208
17031819100,1726,1571,155,218,1508,1439,139,0,17,0,92,39,481,55076
17031819200,2134,1850,284,206,1928,1629,33,0,51,0,379,42,818,63846
17031819300,1015,954,61,37,978,900,29,0,16,0,53,17,213,75639
17031819400,1960,1724,236,352,1608,1534,180,21,31,0,177,17,488,78571
17031819500,1321,1214,107,102,1219,1073,202,0,22,0,0,24,88,79464
17031819600,1233,1209,24,8,1225,1224,0,0,0,0,0,9,26,150273
17031819700,1844,1783,61,43,1801,1821,10,0,7,0,0,6,36,175078
17031819801,1717,1680,37,32,1685,1685,11,0,21,0,0,0,67,162765
17031819802,959,893,66,6,953,931,4,0,7,0,10,7,43,148646
17031819900,1133,1113,20,0,1133,1122,0,0,11,0,0,0,16,179338
17031820000,680,667,13,13,667,541,17,0,122,0,0,0,25,218000
17031820101,2851,2731,120,127,2724,2692,27,0,99,0,19,14,48,100339
17031820103,1443,1360,83,95,1348,1290,18,0,19,0,99,17,331,64152
17031820104,1630,1433,197,196,1434,1449,113,0,16,0,15,37,244,60000
17031820201,3162,3109,53,123,3039,2854,28,0,162,0,72,46,225,106317
17031820202,1229,1096,133,236,993,1145,20,0,4,0,60,0,290,52478
17031820300,1624,1415,209,312,1312,1108,46,0,115,0,355,0,969,58301
17031820400,1644,1296,348,416,1228,942,312,16,11,0,339,24,1043,41144
17031820501,2081,1992,89,81,2000,1944,47,0,58,0,3,29,416,65016
17031820502,1725,1491,234,310,1415,1447,29,0,59,0,157,33,296,52894
17031820603,1917,1663,254,486,1431,1644,121,8,41,0,60,43,408,57557
17031820604,1525,1209,316,355,1170,1378,24,0,0,0,40,83,283,40746
17031820605,1708,1384,324,486,1222,663,981,0,22,0,42,0,240,48148
17031820606,1474,1345,129,48,1426,1298,36,0,34,0,48,58,188,73281
17031820700,2260,2122,138,479,1781,1635,19,0,45,0,561,0,994,59467
17031820800,1141,1051,90,196,945,900,14,0,8,0,197,22,466,71831
17031820901,1828,1612,216,302,1526,1534,129,51,29,0,66,19,547,54625
17031820902,1505,1372,133,173,1332,1270,56,0,18,0,143,18,594,73646
17031821001,1631,1499,132,237,1394,1521,38,0,15,0,31,26,204,57148
17031821002,1785,1627,158,259,1526,1601,24,0,21,0,132,7,434,58153
17031821101,1452,1251,201,258,1194,1223,8,0,23,0,143,55,313,63429
17031821102,1319,1163,156,256,1063,1100,48,0,18,0,109,44,284,63388
17031821200,2202,1856,346,560,1642,745,1085,29,0,0,325,18,744,39939
17031821300,2022,1656,366,510,1512,857,794,27,17,0,323,4,759,43870
17031821401,1529,1245,284,355,1174,88,1335,0,0,0,36,70,87,43560
17031821402,1448,1266,182,158,1290,77,1327,0,0,0,35,9,10,49300
17031821500,664,439,225,257,407,27,614,0,0,0,5,18,5,30222
17031821600,1591,1407,184,228,1363,767,692,0,0,0,106,26,248,64102
17031821700,1700,1652,48,51,1649,1397,297,0,0,0,6,0,63,87500
17031821800,1934,1768,166,121,1813,1283,582,0,0,0,48,21,168,71316
17031821900,1773,1665,108,101,1672,1436,237,0,42,0,44,14,187,71393
17031822000,1718,1585,133,172,1546,1646,29,5,7,0,5,26,192,49359
17031822101,1617,1510,107,112,1505,1395,83,0,0,0,139,0,233,70030
17031822102,1919,1625,294,132,1787,1222,411,0,36,0,204,46,457,54004
17031822200,1265,1221,44,43,1222,1166,16,0,14,0,52,17,212,93723
17031822301,1222,1024,198,123,1099,1142,26,0,17,0,17,20,147,63973
17031822302,1531,1326,205,230,1301,1232,57,0,112,0,106,24,247,54241
17031822400,2064,1616,448,325,1739,1835,103,0,22,0,104,0,302,41902
17031822500,1575,1455,120,159,1416,1428,102,0,8,0,25,12,218,71949
17031822601,1694,1642,52,134,1560,1594,33,0,16,0,51,0,266,77500
17031822602,2753,2516,237,330,2423,2275,211,0,168,0,65,34,269,62843
17031822701,2017,1880,137,310,1707,1586,247,0,56,0,128,0,310,55662
17031822702,1444,1287,157,129,1315,1150,190,0,31,0,63,10,170,52963
17031822801,1481,1275,206,38,1443,1131,173,0,28,0,116,33,273,58569
17031822802,1243,1154,89,109,1134,1180,44,0,6,0,0,13,144,64646
17031822900,674,641,33,80,594,633,0,0,0,0,28,13,69,57857
17031823001,2429,1988,441,575,1854,1788,505,0,74,0,40,22,218,45292
17031823002,2183,1881,302,212,1971,1981,103,0,62,0,16,21,233,50024
17031823101,1675,1444,231,329,1346,1581,65,0,11,0,9,9,98,49702
17031823102,1229,1147,82,157,1072,1154,9,0,0,0,66,0,124,71830
17031823200,1723,1563,160,113,1610,1588,84,0,23,0,28,0,239,68208
17031823302,2353,2106,247,279,2074,1115,1024,25,7,0,107,75,256,49662
17031823303,1558,1313,245,147,1411,1203,240,0,0,0,71,44,317,63065
17031823304,2388,2102,286,347,2041,1576,633,0,34,0,116,29,404,49014
17031823400,1763,1453,310,352,1411,893,427,10,7,0,291,135,643,47371
17031823500,1597,1422,175,323,1274,1017,375,39,6,0,110,50,448,56331
17031823602,2842,2530,312,307,2535,2750,44,0,24,0,24,0,99,63017
17031823603,614,445,169,152,462,208,263,20,0,0,123,0,324,40521
17031823604,1364,1311,53,41,1323,1278,14,0,34,0,25,13,87,86944
17031823605,1543,1371,172,62,1481,1453,54,0,25,0,11,0,35,61250
17031823702,2390,2069,321,188,2202,1942,318,0,50,0,41,39,223,56938
17031823703,2881,2260,621,510,2371,2643,33,0,189,0,16,0,460,53549
17031823704,1321,1298,23,47,1274,1269,16,7,29,0,0,0,83,99306
17031823705,1698,1437,261,192,1506,1568,130,0,0,0,0,0,155,58895
17031823801,2276,2139,137,21,2255,2130,23,0,53,0,50,20,153,88750
17031823803,2289,2099,190,262,2027,2239,0,0,50,0,0,0,85,66287
17031823805,1393,1260,133,56,1337,1332,16,0,26,0,0,19,100,54594
17031823806,1542,1315,227,218,1324,1322,27,13,30,0,97,53,167,50855
17031823901,1493,1439,54,59,1434,1402,0,9,66,9,0,7,31,84116
17031823903,1633,1524,109,67,1566,1555,30,0,0,0,39,9,103,83828
17031823904,1620,1577,43,0,1620,1588,0,7,25,0,0,0,7,85119
17031824003,2077,1935,142,12,2065,2038,0,0,39,0,0,0,99,92984
17031824004,2115,1937,178,205,1910,2081,0,0,34,0,0,0,51,71250
17031824005,2007,1889,118,98,1909,1892,19,0,62,0,6,28,114,106656
17031824006,1497,1421,76,22,1475,1417,0,0,36,0,21,23,78,124519
17031824105,2362,2248,114,141,2221,2218,29,0,86,0,29,0,217,106978
17031824106,2613,2501,112,185,2428,2433,28,0,36,0,21,95,108,91250
17031824107,2603,2498,105,64,2539,2427,67,0,33,0,34,42,187,73825
17031824108,2613,2349,264,187,2426,2233,191,12,146,0,31,0,155,85932
17031824113,2353,2238,115,165,2188,2067,55,0,214,0,17,0,172,95668
17031824114,1887,1805,82,9,1878,1688,89,0,110,0,0,0,18,104861
17031824115,1424,1321,103,126,1298,1235,67,34,74,0,0,14,65,69342
17031824116,2180,1968,212,322,1858,1855,170,0,66,0,78,11,207,67870
17031824117,3385,3264,121,143,3242,3139,54,0,137,0,22,33,137,97899
17031824119,2093,2001,92,33,2060,1892,20,0,120,0,42,19,42,98854
17031824120,3450,3306,144,60,3390,3166,44,0,189,0,36,15,116,105942
17031824121,1242,1140,102,81,1161,1167,31,0,44,0,0,0,27,81480
17031824122,2322,2162,160,43,2279,2234,27,0,49,0,0,12,127,99038
17031824123,2832,2509,323,150,2682,2648,65,0,23,0,52,44,319,66981
17031824300,1620,1011,609,683,937,114,1495,11,0,0,0,0,75,26342
17031824400,805,662,143,85,720,473,277,13,7,0,35,0,93,31694
17031824503,2906,2734,172,249,2657,2651,138,0,63,21,33,0,214,66027
17031824505,2481,2294,187,140,2341,2191,143,0,147,0,0,0,280,80365
17031824506,3229,3169,60,27,3202,2986,85,0,62,0,64,32,209,66024
17031824507,1742,1510,232,189,1553,1534,58,0,81,0,48,21,107,61774
17031824601,1699,1591,108,156,1543,1552,49,0,24,0,57,17,198,75442
17031824602,2389,2148,241,204,2185,2134,124,0,71,0,24,36,204,61461
17031824701,1396,1258,138,165,1231,1139,160,0,0,0,43,54,367,66840
17031824702,2020,1663,357,340,1680,1498,379,12,18,0,74,39,391,52978
17031824800,2287,1794,493,480,1807,1536,436,28,51,0,186,50,1045,46156
17031824900,1108,883,225,393,715,266,793,0,13,0,36,0,83,34000
17031825000,1945,1719,226,237,1708,1427,267,0,103,0,112,36,263,63931
17031825200,687,673,14,34,653,522,83,0,16,0,59,7,206,80592
17031825302,2334,2204,130,193,2141,1868,348,0,72,0,46,0,225,62214
17031825303,1517,1379,138,104,1413,1371,86,0,19,0,41,0,150,65216
17031825304,1641,1522,119,88,1553,1487,0,0,50,0,90,14,207,65720
17031825400,2219,2016,203,113,2106,2055,120,0,44,0,0,0,163,63191
17031825501,1997,1756,241,338,1659,277,1664,30,0,0,26,0,26,48975
17031825503,2624,2243,381,271,2353,489,2068,0,46,0,3,18,24,58531
17031825504,1435,1377,58,283,1152,127,1293,0,0,0,0,15,14,45729
17031825505,1881,1610,271,219,1662,162,1635,0,67,0,0,17,38,62602
17031825600,1663,1366,297,545,1118,312,1240,0,19,0,85,7,170,42417
17031825700,1457,1103,354,343,1114,511,850,0,4,0,68,24,302,43983
17031825801,1341,1058,283,332,1009,99,1235,0,7,0,0,0,18,44456
17031825802,2206,2013,193,683,1523,173,1986,24,0,0,0,23,154,44242
17031825803,2441,2046,395,721,1720,272,2086,0,0,0,70,13,147,47423
17031825900,1162,971,191,296,866,452,691,0,0,0,0,19,293,43587
17031826000,868,736,132,240,628,377,442,12,0,0,37,0,207,45809
17031826100,2151,1790,361,807,1344,874,1255,0,13,0,9,0,330,47390
17031826201,1850,1541,309,280,1570,257,1593,0,0,0,0,0,27,33989
17031826202,1971,1403,568,548,1423,671,1300,0,0,0,0,0,296,39375
17031826301,1424,1182,242,245,1179,172,1207,0,9,0,36,0,100,52917
17031826303,1356,1180,176,211,1145,117,1211,0,9,0,0,19,10,46837
17031826304,1180,841,339,311,869,39,1088,0,0,0,0,53,0,34500
17031826401,1378,1167,211,335,1043,75,1286,10,7,0,0,0,28,53910
17031826402,1600,1333,267,444,1156,112,1427,0,25,0,0,36,22,53221
17031826500,2013,1423,590,687,1326,192,1747,0,13,0,29,32,61,41653
17031826600,2166,1615,551,668,1498,167,1948,0,12,0,39,0,63,38269
17031826700,2083,1476,607,701,1382,136,1921,26,0,0,0,0,21,31725
17031826800,1685,1221,464,411,1274,568,940,0,10,0,133,34,499,37846
17031826901,667,439,228,299,368,50,545,0,0,0,65,7,126,25296
17031826902,562,359,203,192,370,26,529,7,0,0,0,0,7,27697
17031827000,1340,963,377,344,996,65,1226,0,0,0,31,18,67,31716
17031827100,1061,693,368,401,660,81,926,0,22,0,25,7,54,28405
17031827200,1426,1058,368,472,954,338,1031,0,0,0,57,0,231,38077
17031827300,967,605,362,395,572,105,756,0,23,0,73,10,137,21015
17031827400,1691,1089,602,670,1021,69,1510,0,18,0,66,28,148,21455
17031827500,1699,1287,412,462,1237,304,1203,14,0,0,178,0,349,37350
17031827600,1194,945,249,304,890,0,1172,12,0,0,10,0,10,37500
17031827700,918,676,242,263,655,223,682,0,7,0,6,0,67,36657
17031827801,1536,1320,216,360,1176,421,1079,0,0,0,26,10,85,59213
17031827802,1020,909,111,51,969,230,763,0,9,0,18,0,32,67319
17031827804,1166,1045,121,84,1082,220,916,0,9,0,10,11,33,72500
17031827805,1023,966,57,93,930,227,780,0,0,0,0,16,20,63750
17031827901,838,757,81,98,740,64,741,0,15,0,5,13,8,78841
17031827902,1817,1464,353,441,1376,747,935,12,0,0,45,78,300,47844
17031828000,1932,1578,354,364,1568,1102,721,0,0,0,84,25,259,43429
17031828100,1908,1629,279,239,1669,1254,471,0,16,0,144,23,306,54940
17031828201,1670,1554,116,241,1429,693,858,0,0,0,49,70,125,53343
17031828202,1823,1644,179,254,1569,890,838,0,47,0,22,26,109,59935
17031828300,1386,1206,180,82,1304,914,420,0,17,0,11,24,88,57449
17031828401,1500,1377,123,74,1426,999,428,0,14,0,55,4,133,67778
17031828402,1791,1694,97,278,1513,901,855,0,14,0,13,8,99,46713
17031828503,1433,1149,284,433,1000,408,969,0,19,0,31,6,88,38918
17031828504,1940,1533,407,469,1471,551,1240,0,10,0,54,85,159,45625
17031828505,2619,2338,281,288,2331,1377,1146,0,14,0,58,24,162,51485
17031828506,3210,2811,399,592,2618,1256,1888,0,0,0,66,0,253,54518
17031828601,1537,1448,89,74,1463,1181,301,0,12,0,16,27,33,77608
17031828602,1486,1407,79,109,1377,752,702,0,22,0,10,0,31,92630
17031828701,1338,1184,154,113,1225,401,859,14,13,0,16,35,48,74821
17031828702,1724,1471,253,297,1427,420,1215,0,0,0,36,53,91,57361
17031828801,1827,1705,122,102,1725,1090,657,0,17,0,43,20,276,88225
17031828802,1207,1180,27,106,1101,859,289,0,0,0,59,0,241,70337
17031828900,1152,742,410,321,831,286,533,0,0,0,333,0,423,39318
17031829000,447,225,222,255,192,10,437,0,0,0,0,0,10,19716
17031829100,1196,746,450,485,711,230,386,0,0,0,580,0,704,31269
17031829200,1890,1617,273,217,1673,1030,415,0,0,0,423,22,693,48763
17031829301,1470,1210,260,185,1285,705,684,0,7,0,44,30,94,70313
17031829302,1162,686,476,298,864,133,712,0,0,0,289,28,312,26167
17031829401,443,305,138,159,284,19,418,0,0,0,6,0,19,30511
17031829402,1440,1251,189,305,1135,492,867,0,0,0,54,27,71,39375
17031829500,1481,1055,426,260,1221,889,243,8,0,0,326,15,455,38082
17031829600,1213,1000,213,173,1040,950,161,8,9,0,69,16,229,48958
17031829700,1489,1087,402,576,913,323,1066,0,28,0,17,55,92,39044
17031829800,2485,2373,112,96,2389,1298,1169,0,18,0,0,0,32,106079
17031829901,3390,3104,286,283,3107,1347,1901,0,47,0,60,35,198,77098
17031829902,2521,2261,260,336,2185,504,1985,0,19,13,0,0,1,77518
17031830001,1136,1009,127,139,997,1018,81,0,20,0,0,17,162,40417
17031830003,2890,2689,201,204,2686,252,2559,0,0,0,0,79,22,92660
17031830004,2387,2144,243,247,2140,315,1924,0,62,0,63,23,150,85750
17031830005,1712,1668,44,33,1679,513,1140,0,36,0,11,12,0,97237
17031830006,1177,995,182,206,971,340,782,0,33,0,0,22,62,54575
17031830007,1692,1304,388,471,1221,216,1424,0,16,0,28,8,71,44595
17031830008,1433,1366,67,180,1253,160,1208,0,14,0,21,30,37,86160
17031830100,1000,928,72,195,805,351,649,0,0,0,0,0,18,71744
17031830201,2256,1770,486,393,1863,452,1676,0,104,0,0,24,0,49719
17031830202,1067,978,89,150,917,260,721,0,0,0,31,55,78,96607
17031830300,2149,1695,454,414,1735,656,1480,0,0,0,0,13,66,34088
17031830400,1581,1315,266,367,1214,693,810,0,0,0,42,36,69,55570
17031830500,1103,805,298,268,835,658,11,0,0,0,394,40,1094,39401
17031830600,1906,1566,340,405,1501,1264,321,9,97,0,100,115,614,47355
17031830700,1749,1423,326,312,1437,975,569,34,130,0,11,30,163,51950
17031830800,1408,1320,88,38,1370,1291,33,0,43,0,32,9,169,72500
17031830900,1280,1235,45,83,1197,1056,53,10,25,0,66,70,370,102250
17031831000,1071,1056,15,0,1071,1006,9,0,49,0,0,7,75,159020
17031831100,2680,2503,177,107,2573,2194,0,0,121,0,260,105,1244,60745
17031831200,1396,1098,298,260,1136,720,164,7,7,0,498,0,1092,37880
17031831300,365,294,71,132,233,45,198,7,8,0,99,8,151,39896
17031831400,981,768,213,293,688,173,654,13,14,0,90,37,188,33456
17031831500,1187,1026,161,176,1011,893,73,25,42,0,136,18,662,58307
17031831600,2337,2080,257,550,1787,1485,259,49,0,0,521,23,1330,40262
17031831700,764,626,138,170,594,471,15,0,61,0,207,10,395,54737
17031831800,2176,1768,408,419,1757,1619,89,0,339,0,56,73,367,53529
17031831900,1346,1281,65,0,1346,1222,18,0,59,0,10,37,88,109643
17031832000,822,729,93,10,812,706,36,0,60,0,6,14,55,115192
17031832100,1826,1644,182,80,1746,1454,231,34,75,0,0,32,185,72778
17031832200,1478,1407,71,9,1469,1283,11,0,59,0,43,82,164,106840
17031832300,891,839,52,17,874,741,7,0,94,0,0,49,133,104954
17031832400,1191,1133,58,46,1145,1050,13,0,49,0,29,50,275,103750
17031832500,1408,1235,173,161,1247,1306,62,0,19,0,21,0,78,132222
17031832600,1671,1586,85,9,1662,1504,8,0,100,0,0,59,28,148616
17031832900,875,543,332,34,841,597,50,0,176,0,40,12,59,55284
17031833000,2377,1981,396,178,2199,1769,275,0,294,0,0,39,50,141378
17031833100,3719,3296,423,297,3422,2689,469,0,505,0,0,56,203,114007
17031833300,948,616,332,61,887,501,107,0,302,0,6,32,58,52500
17031833900,794,521,273,353,441,383,354,4,9,0,31,13,434,30417
17031834000,1116,756,360,437,679,5,1082,0,10,0,0,19,0,30806
17031834200,1634,1273,361,718,916,21,1594,0,0,0,0,19,10,47727
17031834300,2532,1930,602,560,1972,63,2417,0,20,0,0,32,22,42766
17031834400,1626,1286,340,633,993,107,1479,0,0,0,21,19,44,49091
17031834500,493,331,162,260,233,0,468,0,0,0,13,12,0,31362
17031834600,900,665,235,332,568,28,849,0,0,0,23,0,51,24500
17031834700,541,324,217,280,261,15,503,0,13,0,0,10,21,22104
17031834800,719,394,325,312,407,18,695,0,0,0,0,6,24,21101
17031834900,726,414,312,369,357,0,693,0,0,0,0,33,0,19676
17031835000,1929,1290,639,837,1092,267,1332,0,0,0,314,16,600,26498
17031835100,1357,1055,302,472,885,501,317,21,13,0,460,45,965,39398
17031835200,676,635,41,124,552,423,0,0,30,0,175,48,369,47581
17031835500,704,415,289,418,286,25,665,0,0,0,14,0,20,23051
17031835600,366,299,67,129,237,21,345,0,0,0,0,0,21,23918
17031835700,154,108,46,48,106,0,154,0,0,0,0,0,0,45885
17031835800,650,472,178,240,410,43,586,0,0,0,0,21,25,49239
17031835900,1480,838,642,665,815,38,1412,0,19,0,0,11,31,19015
17031836000,938,702,236,332,606,35,880,0,0,0,9,14,17,65667
17031836100,764,506,258,422,342,30,693,0,8,0,0,33,20,26102
17031836200,126,103,23,0,126,91,15,0,17,0,0,3,0,110357
17031836300,662,509,153,99,563,209,416,0,7,0,20,10,26,49167
17031836400,1774,1160,614,637,1137,140,1556,0,27,0,21,30,89,30616
17031836500,665,513,152,307,358,0,660,0,0,0,5,0,0,29972
17031836600,904,724,180,322,582,314,276,22,0,0,223,69,515,43571
17031836700,884,539,345,375,509,127,610,0,6,0,135,6,172,28365
17031836800,826,311,515,514,312,58,768,0,0,0,0,0,0,13736
17031836900,449,267,182,201,248,73,363,0,5,0,0,8,32,22109
17031837000,754,412,342,415,339,93,639,0,0,0,6,16,35,26538
17031837100,736,509,227,183,553,177,515,0,5,0,39,0,90,25556
17031837300,748,545,203,275,473,6,673,0,7,0,53,9,53,27406
17031837400,702,479,223,334,368,62,626,0,0,0,0,14,0,40417
17031837800,949,705,244,225,724,297,590,0,56,0,0,6,63,60417
17031838000,1219,767,452,467,752,243,878,0,37,8,21,32,114,22951
17031838100,1131,620,511,444,687,303,674,0,144,0,0,10,44,16953
17031838200,387,287,100,31,356,239,41,0,80,0,16,11,78,42313
17031838300,666,548,118,105,561,251,292,0,113,0,0,10,10,58542
17031838600,556,296,260,292,264,5,526,0,0,0,22,3,27,17652
17031838700,1550,865,685,881,669,36,1514,0,0,0,0,0,49,25405
17031838800,1131,661,470,495,636,512,579,0,0,0,40,0,451,25332
17031839000,4789,4176,613,195,4594,3349,661,20,578,0,0,181,405,102188
17031839100,3670,3320,350,67,3603,2327,302,0,915,0,19,107,264,94667
17031839200,1375,1097,278,220,1155,218,886,0,210,0,0,61,71,33295
17031839500,695,420,275,243,452,79,564,0,18,0,10,24,27,19375
17031839600,759,659,100,176,583,48,696,0,5,0,6,4,19,33598
17031839700,1829,1498,331,283,1546,1150,72,14,409,0,134,50,498,50982
17031839800,1190,999,191,72,1118,748,8,0,365,0,59,10,255,50595
17031839900,1830,1541,289,286,1544,1274,80,11,281,0,124,60,377,62536
17031840000,1010,898,112,180,830,560,0,0,327,0,101,22,174,80000
17031840100,1068,899,169,192,876,445,18,0,549,0,32,24,186,46509
17031840200,836,705,131,150,686,280,28,0,443,0,72,13,165,57308
17031840300,1211,962,249,256,955,584,41,0,303,0,283,0,554,48622
17031840400,1168,868,300,155,1013,591,0,0,454,0,99,24,386,44861
17031840700,1082,837,245,272,810,550,20,12,0,0,457,43,888,37966
17031840800,819,577,242,312,507,449,22,0,0,0,348,0,806,31752
17031841000,566,459,107,82,484,186,275,0,82,0,0,23,36,97188
17031841100,2787,1884,903,1002,1785,226,93,0,2384,0,38,46,142,30676
17031841200,1710,1431,279,441,1269,981,75,11,47,0,524,72,1097,44336
17031841300,1499,1153,346,185,1314,605,99,18,30,0,676,71,1113,50039
17031841400,414,285,129,115,299,44,356,0,0,0,14,0,62,26439
17031841500,946,625,321,409,537,31,894,0,0,0,21,0,22,28807
17031841600,234,141,93,82,152,4,209,0,0,0,21,0,21,21974
17031841700,708,452,256,322,386,142,384,0,0,0,157,25,280,22444
17031841800,890,687,203,351,539,13,846,0,0,0,20,11,13,37328
17031841900,1599,1544,55,11,1588,1110,113,0,324,0,24,28,140,116377
17031842000,358,309,49,29,329,70,240,0,38,0,6,4,37,91548
17031842100,2128,1534,594,890,1238,408,1196,0,34,0,490,0,811,35309
17031842200,1923,1724,199,265,1658,1407,310,0,100,0,57,49,165,99440
17031842300,1444,1420,24,41,1403,1145,147,0,113,0,0,39,96,132794
17031842400,1250,967,283,337,913,19,1215,0,16,0,0,0,11,39097
17031842500,825,319,506,585,240,0,825,0,0,0,0,0,0,9787
17031842600,1432,1225,207,219,1213,992,86,18,144,0,175,17,419,62813
17031842800,2036,1350,686,535,1501,990,25,27,124,0,829,41,1652,34327
17031842900,1148,726,422,471,677,218,854,0,49,0,27,0,102,19429
17031843000,927,500,427,586,341,0,898,0,0,0,29,0,18,21198
17031843100,505,290,215,202,303,32,447,0,0,0,13,13,21,20417
17031843200,874,705,169,162,712,541,34,0,12,0,251,36,567,47083
17031843300,442,309,133,178,264,113,258,0,0,0,57,14,154,47321
17031843400,507,385,122,176,331,104,341,0,0,0,62,0,148,25078
17031843500,295,205,90,73,222,152,0,0,0,0,143,0,281,27891
17031843600,1353,1033,320,479,874,66,1219,0,26,0,19,23,45,39602
17031843700,985,910,75,77,908,860,41,0,55,0,10,19,202,112386
17031843800,624,509,115,199,425,184,404,0,28,0,8,0,72,34375
17031843900,1978,1536,442,485,1493,105,1716,0,66,0,55,36,80,34381
17031980000,0,0,0,0,0,0,0,0,0,0,0,0,0,-
17031980100,0,0,0,0,0,0,0,0,0,0,0,0,0,-
17031990000,0,0,0,0,0,0,0,0,0,0,0,0,0,-